GameType, Year, locCity, locCountry, Rank, partCountry, Gold, Silver, Bronze, Total
Winter,2010,Vancouver,Canada,1,United States,9,15,13,37
Winter,2010,Vancouver,Canada,2,Germany,10,13,7,30
Winter,2010,Vancouver,Canada,3,Canada,14,7,5,26
Winter,2010,Vancouver,Canada,4,Norway,9,8,6,23
Winter,2010,Vancouver,Canada,5,Austria,4,6,6,16
Winter,2010,Vancouver,Canada,6,Russia,3,5,7,15
Winter,2010,Vancouver,Canada,7,South Korea,6,6,2,14
Winter,2010,Vancouver,Canada,8,Sweden,5,2,4,11
Winter,2010,Vancouver,Canada,9,China,5,2,4,11
Winter,2010,Vancouver,Canada,10,France,2,3,6,11
Winter,2010,Vancouver,Canada,11,Switzerland,6,0,3,9
Winter,2010,Vancouver,Canada,12,Netherlands,4,1,3,8
Winter,2010,Vancouver,Canada,13,Czech Republic,2,0,4,6
Winter,2010,Vancouver,Canada,14,Poland,1,3,2,6
Winter,2010,Vancouver,Canada,15,Italy,1,1,3,5
Winter,2010,Vancouver,Canada,16,Japan,0,3,2,5
Winter,2010,Vancouver,Canada,17,Finland,0,1,4,5
Winter,2010,Vancouver,Canada,18,Australia,2,1,0,3
Winter,2010,Vancouver,Canada,19,Slovakia,1,1,1,3
Winter,2010,Vancouver,Canada,20,Belarus,1,1,1,3
Winter,2010,Vancouver,Canada,21,Croatia,0,2,1,3
Winter,2010,Vancouver,Canada,22,Slovenia,0,2,1,3
Winter,2010,Vancouver,Canada,23,Latvia,0,2,0,2
Winter,2010,Vancouver,Canada,24,Great Britain,1,0,0,1
Winter,2010,Vancouver,Canada,25,Kazakhstan,0,1,0,1
Winter,2010,Vancouver,Canada,26,Estonia,0,1,0,1
Winter,2006,Torino,Italy,1,Germany,11,12,6,29
Winter,2006,Torino,Italy,2,United States,9,9,7,25
Winter,2006,Torino,Italy,3,Canada,7,10,7,24
Winter,2006,Torino,Italy,4,Austria,9,7,7,23
Winter,2006,Torino,Italy,5,Russia,8,6,8,22
Winter,2006,Torino,Italy,6,Norway,2,8,9,19
Winter,2006,Torino,Italy,7,Sweden,7,2,5,14
Winter,2006,Torino,Italy,8,Switzerland,5,4,5,14
Winter,2006,Torino,Italy,9,South Korea,6,3,2,11
Winter,2006,Torino,Italy,10,Italy,5,0,6,11
Winter,2006,Torino,Italy,11,China,2,4,5,11
Winter,2006,Torino,Italy,12,France,3,2,4,9
Winter,2006,Torino,Italy,13,Netherlands,3,2,4,9
Winter,2006,Torino,Italy,14,Finland,0,6,3,9
Winter,2006,Torino,Italy,15,Czech Republic,1,2,1,4
Winter,2006,Torino,Italy,16,Estonia,3,0,0,3
Winter,2006,Torino,Italy,17,Croatia,1,2,0,3
Winter,2006,Torino,Italy,18,Australia,1,0,1,2
Winter,2006,Torino,Italy,19,Poland,0,1,1,2
Winter,2006,Torino,Italy,20,Ukraine,0,0,2,2
Winter,2006,Torino,Italy,21,Japan,1,0,0,1
Winter,2006,Torino,Italy,22,Great Britain,0,1,0,1
Winter,2006,Torino,Italy,23,Slovakia,0,1,0,1
Winter,2006,Torino,Italy,24,Bulgaria,0,1,0,1
Winter,2006,Torino,Italy,25,Belarus,0,1,0,1
Winter,2006,Torino,Italy,26,Latvia,0,0,1,1
Winter,2002,Salt Lake City,United States,1,Germany,12,16,8,36
Winter,2002,Salt Lake City,United States,2,United States,10,13,11,34
Winter,2002,Salt Lake City,United States,3,Norway,13,5,7,25
Winter,2002,Salt Lake City,United States,4,Canada,7,3,7,17
Winter,2002,Salt Lake City,United States,5,Austria,3,4,10,17
Winter,2002,Salt Lake City,United States,6,Russia,5,4,4,13
Winter,2002,Salt Lake City,United States,7,Italy,4,4,5,13
Winter,2002,Salt Lake City,United States,8,France,4,5,2,11
Winter,2002,Salt Lake City,United States,9,Switzerland,3,2,6,11
Winter,2002,Salt Lake City,United States,10,Netherlands,3,5,0,8
Winter,2002,Salt Lake City,United States,11,China,2,2,4,8
Winter,2002,Salt Lake City,United States,12,Finland,4,2,1,7
Winter,2002,Salt Lake City,United States,13,Sweden,0,2,5,7
Winter,2002,Salt Lake City,United States,14,Croatia,3,1,0,4
Winter,2002,Salt Lake City,United States,15,South Korea,2,2,0,4
Winter,2002,Salt Lake City,United States,16,Czech Republic,1,2,0,3
Winter,2002,Salt Lake City,United States,17,Estonia,1,1,1,3
Winter,2002,Salt Lake City,United States,18,Bulgaria,0,1,2,3
Winter,2002,Salt Lake City,United States,19,Australia,2,0,0,2
Winter,2002,Salt Lake City,United States,20,Great Britain,1,0,1,2
Winter,2002,Salt Lake City,United States,21,Poland,0,1,1,2
Winter,2002,Salt Lake City,United States,22,Japan,0,1,1,2
Winter,2002,Salt Lake City,United States,23,Belarus,0,0,1,1
Winter,2002,Salt Lake City,United States,24,Slovenia,0,0,1,1
Winter,1998,Nagano,Japan,1,Germany,12,9,8,29
Winter,1998,Nagano,Japan,2,Norway,10,10,5,25
Winter,1998,Nagano,Japan,3,Russia,9,6,3,18
Winter,1998,Nagano,Japan,4,Austria,3,5,9,17
Winter,1998,Nagano,Japan,5,Canada,6,5,4,15
Winter,1998,Nagano,Japan,6,United States,6,3,4,13
Winter,1998,Nagano,Japan,7,Finland,2,4,6,12
Winter,1998,Nagano,Japan,8,Netherlands,5,4,2,11
Winter,1998,Nagano,Japan,9,Japan,5,1,4,10
Winter,1998,Nagano,Japan,10,Italy,2,6,2,10
Winter,1998,Nagano,Japan,11,France,2,1,5,8
Winter,1998,Nagano,Japan,12,China,0,6,2,8
Winter,1998,Nagano,Japan,13,Switzerland,2,2,3,7
Winter,1998,Nagano,Japan,14,South Korea,3,1,2,6
Winter,1998,Nagano,Japan,15,Czech Republic,1,1,1,3
Winter,1998,Nagano,Japan,16,Sweden,0,2,1,3
Winter,1998,Nagano,Japan,17,Belarus,0,0,2,2
Winter,1998,Nagano,Japan,18,Kazakhstan,0,0,2,2
Winter,1998,Nagano,Japan,19,Bulgaria,1,0,0,1
Winter,1998,Nagano,Japan,20,Denmark,0,1,0,1
Winter,1998,Nagano,Japan,21,Ukraine,0,1,0,1
Winter,1998,Nagano,Japan,22,Great Britain,0,0,1,1
Winter,1998,Nagano,Japan,23,Australia,0,0,1,1
Winter,1998,Nagano,Japan,24,Belgium,0,0,1,1
Winter,1994,Lillehammer,Norway,1,Norway,10,11,5,26
Winter,1994,Lillehammer,Norway,2,Germany,9,7,8,24
Winter,1994,Lillehammer,Norway,3,Russia,11,8,4,23
Winter,1994,Lillehammer,Norway,4,Italy,7,5,8,20
Winter,1994,Lillehammer,Norway,5,United States,6,5,2,13
Winter,1994,Lillehammer,Norway,6,Canada,3,6,4,13
Winter,1994,Lillehammer,Norway,7,Switzerland,3,4,2,9
Winter,1994,Lillehammer,Norway,8,Austria,2,3,4,9
Winter,1994,Lillehammer,Norway,9,South Korea,4,1,1,6
Winter,1994,Lillehammer,Norway,10,Finland,0,1,5,6
Winter,1994,Lillehammer,Norway,11,Japan,1,2,2,5
Winter,1994,Lillehammer,Norway,12,France,0,1,4,5
Winter,1994,Lillehammer,Norway,13,Netherlands,0,1,3,4
Winter,1994,Lillehammer,Norway,14,Sweden,2,1,0,3
Winter,1994,Lillehammer,Norway,15,Kazakhstan,1,2,0,3
Winter,1994,Lillehammer,Norway,16,China,0,1,2,3
Winter,1994,Lillehammer,Norway,17,Slovenia,0,0,3,3
Winter,1994,Lillehammer,Norway,18,Ukraine,1,0,1,2
Winter,1994,Lillehammer,Norway,19,Belarus,0,2,0,2
Winter,1994,Lillehammer,Norway,20,Great Britain,0,0,2,2
Winter,1994,Lillehammer,Norway,21,Uzbekistan,1,0,0,1
Winter,1994,Lillehammer,Norway,22,Australia,0,0,1,1
Winter,1992,Albertville,France,1,Germany,10,10,6,26
Winter,1992,Albertville,France,2,Unified Team,9,6,8,23
Winter,1992,Albertville,France,3,Austria,6,7,8,21
Winter,1992,Albertville,France,4,Norway,9,6,5,20
Winter,1992,Albertville,France,5,Italy,4,6,4,14
Winter,1992,Albertville,France,6,United States,5,4,2,11
Winter,1992,Albertville,France,7,France,3,5,1,9
Winter,1992,Albertville,France,8,Finland,3,1,3,7
Winter,1992,Albertville,France,9,Canada,2,3,2,7
Winter,1992,Albertville,France,10,Japan,1,2,4,7
Winter,1992,Albertville,France,11,South Korea,2,1,1,4
Winter,1992,Albertville,France,12,Netherlands,1,1,2,4
Winter,1992,Albertville,France,13,Sweden,1,0,3,4
Winter,1992,Albertville,France,14,Switzerland,1,0,2,3
Winter,1992,Albertville,France,15,China,0,3,0,3
Winter,1992,Albertville,France,16,Czechoslovakia,0,0,3,3
Winter,1992,Albertville,France,17,Luxembourg,0,2,0,2
Winter,1992,Albertville,France,18,New Zealand,0,1,0,1
Winter,1992,Albertville,France,19,Spain,0,0,1,1
Winter,1992,Albertville,France,20,North Korea,0,0,1,1
Winter,1988,Calgary,Canada,1,Soviet Union,11,9,9,29
Winter,1988,Calgary,Canada,2,East Germany,9,10,6,25
Winter,1988,Calgary,Canada,3,Switzerland,5,5,5,15
Winter,1988,Calgary,Canada,4,Austria,3,5,2,10
Winter,1988,Calgary,Canada,5,West Germany,2,4,2,8
Winter,1988,Calgary,Canada,6,Finland,4,1,2,7
Winter,1988,Calgary,Canada,7,Netherlands,3,2,2,7
Winter,1988,Calgary,Canada,8,Sweden,4,0,2,6
Winter,1988,Calgary,Canada,9,United States,2,1,3,6
Winter,1988,Calgary,Canada,10,Italy,2,1,2,5
Winter,1988,Calgary,Canada,11,Norway,0,3,2,5
Winter,1988,Calgary,Canada,12,Canada,0,2,3,5
Winter,1988,Calgary,Canada,13,Yugoslavia,0,2,1,3
Winter,1988,Calgary,Canada,14,Czechoslovakia,0,1,2,3
Winter,1988,Calgary,Canada,15,France,1,0,1,2
Winter,1988,Calgary,Canada,16,Liechtenstein,0,0,1,1
Winter,1988,Calgary,Canada,17,Japan,0,0,1,1
Winter,1984,Sarajevo,Yugoslavia,1,Soviet Union,6,10,9,25
Winter,1984,Sarajevo,Yugoslavia,2,East Germany,9,9,6,24
Winter,1984,Sarajevo,Yugoslavia,3,Finland,4,3,6,13
Winter,1984,Sarajevo,Yugoslavia,4,Norway,3,2,4,9
Winter,1984,Sarajevo,Yugoslavia,5,United States,4,4,0,8
Winter,1984,Sarajevo,Yugoslavia,6,Sweden,4,2,2,8
Winter,1984,Sarajevo,Yugoslavia,7,Czechoslovakia,0,2,4,6
Winter,1984,Sarajevo,Yugoslavia,8,Switzerland,2,2,1,5
Winter,1984,Sarajevo,Yugoslavia,9,West Germany,2,1,1,4
Winter,1984,Sarajevo,Yugoslavia,10,Canada,2,1,1,4
Winter,1984,Sarajevo,Yugoslavia,11,France,0,1,2,3
Winter,1984,Sarajevo,Yugoslavia,12,Italy,2,0,0,2
Winter,1984,Sarajevo,Yugoslavia,13,Liechtenstein,0,0,2,2
Winter,1984,Sarajevo,Yugoslavia,14,Great Britain,1,0,0,1
Winter,1984,Sarajevo,Yugoslavia,15,Yugoslavia,0,1,0,1
Winter,1984,Sarajevo,Yugoslavia,16,Japan,0,1,0,1
Winter,1984,Sarajevo,Yugoslavia,17,Austria,0,0,1,1
Winter,1980,Lake Placid,United States,1,East Germany,9,7,7,23
Winter,1980,Lake Placid,United States,2,Soviet Union,10,6,6,22
Winter,1980,Lake Placid,United States,3,United States,6,4,2,12
Winter,1980,Lake Placid,United States,4,Norway,1,3,6,10
Winter,1980,Lake Placid,United States,5,Finland,1,5,3,9
Winter,1980,Lake Placid,United States,6,Austria,3,2,2,7
Winter,1980,Lake Placid,United States,7,Switzerland,1,1,3,5
Winter,1980,Lake Placid,United States,8,West Germany,0,2,3,5
Winter,1980,Lake Placid,United States,9,Sweden,3,0,1,4
Winter,1980,Lake Placid,United States,10,Liechtenstein,2,2,0,4
Winter,1980,Lake Placid,United States,11,Netherlands,1,2,1,4
Winter,1980,Lake Placid,United States,12,Italy,0,2,0,2
Winter,1980,Lake Placid,United States,13,Canada,0,1,1,2
Winter,1980,Lake Placid,United States,14,Great Britain,1,0,0,1
Winter,1980,Lake Placid,United States,15,Japan,0,1,0,1
Winter,1980,Lake Placid,United States,16,Hungary,0,1,0,1
Winter,1980,Lake Placid,United States,17,France,0,0,1,1
Winter,1980,Lake Placid,United States,18,Bulgaria,0,0,1,1
Winter,1980,Lake Placid,United States,19,Czechoslovakia,0,0,1,1
Winter,1976,Innsbruck,Austria,1,Soviet Union,13,6,8,27
Winter,1976,Innsbruck,Austria,2,East Germany,7,5,7,19
Winter,1976,Innsbruck,Austria,3,United States,3,3,4,10
Winter,1976,Innsbruck,Austria,4,West Germany,2,5,3,10
Winter,1976,Innsbruck,Austria,5,Norway,3,3,1,7
Winter,1976,Innsbruck,Austria,6,Finland,2,4,1,7
Winter,1976,Innsbruck,Austria,7,Austria,2,2,2,6
Winter,1976,Innsbruck,Austria,8,Netherlands,1,2,3,6
Winter,1976,Innsbruck,Austria,9,Switzerland,1,3,1,5
Winter,1976,Innsbruck,Austria,10,Italy,1,2,1,4
Winter,1976,Innsbruck,Austria,11,Canada,1,1,1,3
Winter,1976,Innsbruck,Austria,12,Sweden,0,0,2,2
Winter,1976,Innsbruck,Austria,13,Liechtenstein,0,0,2,2
Winter,1976,Innsbruck,Austria,14,Great Britain,1,0,0,1
Winter,1976,Innsbruck,Austria,15,Czechoslovakia,0,1,0,1
Winter,1976,Innsbruck,Austria,16,France,0,0,1,1
Winter,1972,Sapporo,Japan,1,Soviet Union,8,5,3,16
Winter,1972,Sapporo,Japan,2,East Germany,4,3,7,14
Winter,1972,Sapporo,Japan,3,Norway,2,5,5,12
Winter,1972,Sapporo,Japan,4,Switzerland,4,3,3,10
Winter,1972,Sapporo,Japan,5,Netherlands,4,3,2,9
Winter,1972,Sapporo,Japan,6,United States,3,2,3,8
Winter,1972,Sapporo,Japan,7,West Germany,3,1,1,5
Winter,1972,Sapporo,Japan,8,Italy,2,2,1,5
Winter,1972,Sapporo,Japan,9,Austria,1,2,2,5
Winter,1972,Sapporo,Japan,10,Finland,0,4,1,5
Winter,1972,Sapporo,Japan,11,Sweden,1,1,2,4
Winter,1972,Sapporo,Japan,12,Japan,1,1,1,3
Winter,1972,Sapporo,Japan,13,Czechoslovakia,1,0,2,3
Winter,1972,Sapporo,Japan,14,France,0,1,2,3
Winter,1972,Sapporo,Japan,15,Poland,1,0,0,1
Winter,1972,Sapporo,Japan,16,Spain,1,0,0,1
Winter,1972,Sapporo,Japan,17,Canada,0,1,0,1
Winter,1968,Grenoble,France,1,Norway,6,6,2,14
Winter,1968,Grenoble,France,2,Soviet Union,5,5,3,13
Winter,1968,Grenoble,France,3,Austria,3,4,4,11
Winter,1968,Grenoble,France,4,France,4,3,2,9
Winter,1968,Grenoble,France,5,Netherlands,3,3,3,9
Winter,1968,Grenoble,France,6,Sweden,3,2,3,8
Winter,1968,Grenoble,France,7,West Germany,2,2,3,7
Winter,1968,Grenoble,France,8,United States,1,5,1,7
Winter,1968,Grenoble,France,9,Switzerland,0,2,4,6
Winter,1968,Grenoble,France,10,East Germany,1,2,2,5
Winter,1968,Grenoble,France,11,Finland,1,2,2,5
Winter,1968,Grenoble,France,12,Italy,4,0,0,4
Winter,1968,Grenoble,France,13,Czechoslovakia,1,2,1,4
Winter,1968,Grenoble,France,14,Canada,1,1,1,3
Winter,1968,Grenoble,France,15,Romania,0,0,1,1
Winter,1964,Innsbruck,Austria,1,Soviet Union,11,8,6,25
Winter,1964,Innsbruck,Austria,2,Norway,3,6,6,15
Winter,1964,Innsbruck,Austria,3,Austria,4,5,3,12
Winter,1964,Innsbruck,Austria,4,Finland,3,4,3,10
Winter,1964,Innsbruck,Austria,5,Germany,3,3,3,9
Winter,1964,Innsbruck,Austria,6,France,3,4,0,7
Winter,1964,Innsbruck,Austria,7,Sweden,3,3,1,7
Winter,1964,Innsbruck,Austria,8,United States,1,2,4,7
Winter,1964,Innsbruck,Austria,9,Italy,0,1,3,4
Winter,1964,Innsbruck,Austria,10,Canada,1,1,1,3
Winter,1964,Innsbruck,Austria,11,Netherlands,1,1,0,2
Winter,1964,Innsbruck,Austria,12,Great Britain,1,0,0,1
Winter,1964,Innsbruck,Austria,13,North Korea,0,1,0,1
Winter,1964,Innsbruck,Austria,14,Czechoslovakia,0,0,1,1
Winter,1960,Squaw Valley,United States,1,Soviet Union,7,5,9,21
Winter,1960,Squaw Valley,United States,2,United States,3,4,3,10
Winter,1960,Squaw Valley,United States,3,Germany,4,3,1,8
Winter,1960,Squaw Valley,United States,4,Finland,2,3,3,8
Winter,1960,Squaw Valley,United States,5,Sweden,3,2,2,7
Winter,1960,Squaw Valley,United States,6,Norway,3,3,0,6
Winter,1960,Squaw Valley,United States,7,Austria,1,2,3,6
Winter,1960,Squaw Valley,United States,8,Canada,2,1,1,4
Winter,1960,Squaw Valley,United States,9,France,1,0,2,3
Winter,1960,Squaw Valley,United States,10,Switzerland,2,0,0,2
Winter,1960,Squaw Valley,United States,11,Netherlands,0,1,1,2
Winter,1960,Squaw Valley,United States,12,Poland,0,1,1,2
Winter,1960,Squaw Valley,United States,13,Czechoslovakia,0,1,0,1
Winter,1960,Squaw Valley,United States,14,Italy,0,0,1,1
Winter,1956,Cortina d'Ampezzo,Italy,1,Soviet Union,7,3,6,16
Winter,1956,Cortina d'Ampezzo,Italy,2,Austria,4,3,4,11
Winter,1956,Cortina d'Ampezzo,Italy,3,Sweden,2,4,4,10
Winter,1956,Cortina d'Ampezzo,Italy,4,Finland,3,3,1,7
Winter,1956,Cortina d'Ampezzo,Italy,5,United States,2,3,2,7
Winter,1956,Cortina d'Ampezzo,Italy,6,Switzerland,3,2,1,6
Winter,1956,Cortina d'Ampezzo,Italy,7,Norway,2,1,1,4
Winter,1956,Cortina d'Ampezzo,Italy,8,Italy,1,2,0,3
Winter,1956,Cortina d'Ampezzo,Italy,9,Canada,0,1,2,3
Winter,1956,Cortina d'Ampezzo,Italy,10,Germany,1,0,1,2
Winter,1956,Cortina d'Ampezzo,Italy,11,Japan,0,1,0,1
Winter,1956,Cortina d'Ampezzo,Italy,12,Poland,0,0,1,1
Winter,1956,Cortina d'Ampezzo,Italy,13,Hungary,0,0,1,1
Winter,1952,Oslo,Norway,1,Norway,7,3,6,16
Winter,1952,Oslo,Norway,2,United States,4,6,1,11
Winter,1952,Oslo,Norway,3,Finland,3,4,2,9
Winter,1952,Oslo,Norway,4,Austria,2,4,2,8
Winter,1952,Oslo,Norway,5,Germany,3,2,2,7
Winter,1952,Oslo,Norway,6,Sweden,0,0,4,4
Winter,1952,Oslo,Norway,7,Netherlands,0,3,0,3
Winter,1952,Oslo,Norway,8,Italy,1,0,1,2
Winter,1952,Oslo,Norway,9,Canada,1,0,1,2
Winter,1952,Oslo,Norway,10,Switzerland,0,0,2,2
Winter,1952,Oslo,Norway,11,Great Britain,1,0,0,1
Winter,1952,Oslo,Norway,12,France,0,0,1,1
Winter,1952,Oslo,Norway,13,Hungary,0,0,1,1
Winter,1948,Sankt Moritz,Switzerland,1,Norway,4,3,3,10
Winter,1948,Sankt Moritz,Switzerland,2,Sweden,4,3,3,10
Winter,1948,Sankt Moritz,Switzerland,3,Switzerland,3,4,3,10
Winter,1948,Sankt Moritz,Switzerland,4,United States,3,4,2,9
Winter,1948,Sankt Moritz,Switzerland,5,Austria,1,3,4,8
Winter,1948,Sankt Moritz,Switzerland,6,Finland,1,3,2,6
Winter,1948,Sankt Moritz,Switzerland,7,France,2,1,2,5
Winter,1948,Sankt Moritz,Switzerland,8,Canada,2,0,1,3
Winter,1948,Sankt Moritz,Switzerland,9,Belgium,1,1,0,2
Winter,1948,Sankt Moritz,Switzerland,10,Great Britain,0,0,2,2
Winter,1948,Sankt Moritz,Switzerland,11,Italy,1,0,0,1
Winter,1948,Sankt Moritz,Switzerland,12,Hungary,0,1,0,1
Winter,1948,Sankt Moritz,Switzerland,13,Czechoslovakia,0,1,0,1
Winter,1936,Garmisch-Partenkirchen,Germany,1,Norway,7,5,3,15
Winter,1936,Garmisch-Partenkirchen,Germany,2,Sweden,2,2,3,7
Winter,1936,Garmisch-Partenkirchen,Germany,3,Germany,3,3,0,6
Winter,1936,Garmisch-Partenkirchen,Germany,4,Finland,1,2,3,6
Winter,1936,Garmisch-Partenkirchen,Germany,5,Austria,1,1,2,4
Winter,1936,Garmisch-Partenkirchen,Germany,6,United States,1,0,3,4
Winter,1936,Garmisch-Partenkirchen,Germany,7,Switzerland,1,2,0,3
Winter,1936,Garmisch-Partenkirchen,Germany,8,Great Britain,1,1,1,3
Winter,1936,Garmisch-Partenkirchen,Germany,9,Canada,0,1,0,1
Winter,1936,Garmisch-Partenkirchen,Germany,10,France,0,0,1,1
Winter,1936,Garmisch-Partenkirchen,Germany,11,Hungary,0,0,1,1
Winter,1932,Lake Placid,United States,1,United States,6,4,2,12
Winter,1932,Lake Placid,United States,2,Norway,3,4,3,10
Winter,1932,Lake Placid,United States,3,Canada,1,1,5,7
Winter,1932,Lake Placid,United States,4,Sweden,1,2,0,3
Winter,1932,Lake Placid,United States,5,Finland,1,1,1,3
Winter,1932,Lake Placid,United States,6,Austria,1,1,0,2
Winter,1932,Lake Placid,United States,7,Germany,0,0,2,2
Winter,1932,Lake Placid,United States,8,France,1,0,0,1
Winter,1932,Lake Placid,United States,9,Switzerland,0,1,0,1
Winter,1932,Lake Placid,United States,10,Hungary,0,0,1,1
Winter,1928,Sankt Moritz,Switzerland,1,Norway,6,4,5,15
Winter,1928,Sankt Moritz,Switzerland,2,United States,2,2,2,6
Winter,1928,Sankt Moritz,Switzerland,3,Sweden,2,2,1,5
Winter,1928,Sankt Moritz,Switzerland,4,Finland,2,1,1,4
Winter,1928,Sankt Moritz,Switzerland,5,Austria,0,3,1,4
Winter,1928,Sankt Moritz,Switzerland,6,France,1,0,0,1
Winter,1928,Sankt Moritz,Switzerland,7,Canada,1,0,0,1
Winter,1928,Sankt Moritz,Switzerland,8,Great Britain,0,0,1,1
Winter,1928,Sankt Moritz,Switzerland,9,Germany,0,0,1,1
Winter,1928,Sankt Moritz,Switzerland,10,Czechoslovakia,0,0,1,1
Winter,1928,Sankt Moritz,Switzerland,11,Belgium,0,0,1,1
Winter,1928,Sankt Moritz,Switzerland,12,Switzerland,0,0,1,1
Winter,1924,Chamonix,France,1,Norway,4,7,6,17
Winter,1924,Chamonix,France,2,Finland,4,4,3,11
Winter,1924,Chamonix,France,3,United States,1,2,1,4
Winter,1924,Chamonix,France,4,Great Britain,1,1,2,4
Winter,1924,Chamonix,France,5,Austria,2,1,0,3
Winter,1924,Chamonix,France,6,Switzerland,2,0,1,3
Winter,1924,Chamonix,France,7,France,0,0,3,3
Winter,1924,Chamonix,France,8,Sweden,1,1,0,2
Winter,1924,Chamonix,France,9,Canada,1,0,0,1
Winter,1924,Chamonix,France,10,Mixed team,1,0,0,1
Winter,1924,Chamonix,France,11,Belgium,0,0,1,1
Summer,2012,London,Great Britain,1,United States,46,29,29,104
Summer,2012,London,Great Britain,2,China,38,27,23,88
Summer,2012,London,Great Britain,3,Russia,24,26,32,82
Summer,2012,London,Great Britain,4,Great Britain,29,17,19,65
Summer,2012,London,Great Britain,5,Germany,11,19,14,44
Summer,2012,London,Great Britain,6,Japan,7,14,17,38
Summer,2012,London,Great Britain,7,Australia,7,16,12,35
Summer,2012,London,Great Britain,8,France,11,11,12,34
Summer,2012,London,Great Britain,9,South Korea,13,8,7,28
Summer,2012,London,Great Britain,10,Italy,8,9,11,28
Summer,2012,London,Great Britain,11,Netherlands,6,6,8,20
Summer,2012,London,Great Britain,12,Ukraine,6,5,9,20
Summer,2012,London,Great Britain,13,Hungary,8,4,6,18
Summer,2012,London,Great Britain,14,Canada,1,5,12,18
Summer,2012,London,Great Britain,15,Spain,3,10,4,17
Summer,2012,London,Great Britain,16,Brazil,3,5,9,17
Summer,2012,London,Great Britain,17,Cuba,5,3,6,14
Summer,2012,London,Great Britain,18,Kazakhstan,7,1,5,13
Summer,2012,London,Great Britain,19,New Zealand,6,2,5,13
Summer,2012,London,Great Britain,20,Iran,4,5,3,12
Summer,2012,London,Great Britain,21,Jamaica,4,4,4,12
Summer,2012,London,Great Britain,22,Belarus,2,5,5,12
Summer,2012,London,Great Britain,23,Kenya,2,4,5,11
Summer,2012,London,Great Britain,24,Czech Republic,4,3,3,10
Summer,2012,London,Great Britain,25,Azerbaijan,2,2,6,10
Summer,2012,London,Great Britain,26,Poland,2,2,6,10
Summer,2012,London,Great Britain,27,Romania,2,5,2,9
Summer,2012,London,Great Britain,28,Denmark,2,4,3,9
Summer,2012,London,Great Britain,29,Sweden,1,4,3,8
Summer,2012,London,Great Britain,30,Colombia,1,3,4,8
Summer,2012,London,Great Britain,31,Ethiopia,3,1,3,7
Summer,2012,London,Great Britain,32,Mexico,1,3,3,7
Summer,2012,London,Great Britain,33,Georgia,1,3,3,7
Summer,2012,London,Great Britain,34,North Korea,4,0,2,6
Summer,2012,London,Great Britain,35,South Africa,3,2,1,6
Summer,2012,London,Great Britain,36,Croatia,3,1,2,6
Summer,2012,London,Great Britain,37,India,0,2,4,6
Summer,2012,London,Great Britain,38,Turkey,2,2,1,5
Summer,2012,London,Great Britain,39,Lithuania,2,1,2,5
Summer,2012,London,Great Britain,40,Ireland,1,1,3,5
Summer,2012,London,Great Britain,41,Mongolia,0,2,3,5
Summer,2012,London,Great Britain,42,Switzerland,2,2,0,4
Summer,2012,London,Great Britain,43,Norway,2,1,1,4
Summer,2012,London,Great Britain,44,Slovenia,1,1,2,4
Summer,2012,London,Great Britain,45,Argentina,1,1,2,4
Summer,2012,London,Great Britain,46,Serbia,1,1,2,4
Summer,2012,London,Great Britain,47,Trinidad and Tobago,1,0,3,4
Summer,2012,London,Great Britain,48,Slovakia,0,1,3,4
Summer,2012,London,Great Britain,49,Tunisia,1,1,1,3
Summer,2012,London,Great Britain,50,Uzbekistan,1,0,2,3
Summer,2012,London,Great Britain,51,Thailand,0,2,1,3
Summer,2012,London,Great Britain,52,Belgium,0,1,2,3
Summer,2012,London,Great Britain,53,Armenia,0,1,2,3
Summer,2012,London,Great Britain,54,Finland,0,1,2,3
Summer,2012,London,Great Britain,55,Dominican Republic,1,1,0,2
Summer,2012,London,Great Britain,56,Latvia,1,0,1,2
Summer,2012,London,Great Britain,57,Egypt,0,2,0,2
Summer,2012,London,Great Britain,58,Chinese Taipei,0,1,1,2
Summer,2012,London,Great Britain,59,Indonesia,0,1,1,2
Summer,2012,London,Great Britain,60,Puerto Rico,0,1,1,2
Summer,2012,London,Great Britain,61,Estonia,0,1,1,2
Summer,2012,London,Great Britain,62,Bulgaria,0,1,1,2
Summer,2012,London,Great Britain,63,Malaysia,0,1,1,2
Summer,2012,London,Great Britain,64,Greece,0,0,2,2
Summer,2012,London,Great Britain,65,Singapore,0,0,2,2
Summer,2012,London,Great Britain,66,Moldova,0,0,2,2
Summer,2012,London,Great Britain,67,Qatar,0,0,2,2
Summer,2012,London,Great Britain,68,Grenada,1,0,0,1
Summer,2012,London,Great Britain,69,Algeria,1,0,0,1
Summer,2012,London,Great Britain,70,Uganda,1,0,0,1
Summer,2012,London,Great Britain,71,Bahamas,1,0,0,1
Summer,2012,London,Great Britain,72,Venezuela,1,0,0,1
Summer,2012,London,Great Britain,73,Guatemala,0,1,0,1
Summer,2012,London,Great Britain,74,Botswana,0,1,0,1
Summer,2012,London,Great Britain,75,Portugal,0,1,0,1
Summer,2012,London,Great Britain,76,Montenegro,0,1,0,1
Summer,2012,London,Great Britain,77,Cyprus,0,1,0,1
Summer,2012,London,Great Britain,78,Gabon,0,1,0,1
Summer,2012,London,Great Britain,79,Kuwait,0,0,1,1
Summer,2012,London,Great Britain,80,Afghanistan,0,0,1,1
Summer,2012,London,Great Britain,81,Morocco,0,0,1,1
Summer,2012,London,Great Britain,82,Bahrain,0,0,1,1
Summer,2012,London,Great Britain,83,Tajikistan,0,0,1,1
Summer,2012,London,Great Britain,84,Hong Kong,0,0,1,1
Summer,2012,London,Great Britain,85,Saudi Arabia,0,0,1,1
Summer,2008,Beijing,China,1,United States,36,38,36,110
Summer,2008,Beijing,China,2,China,51,21,28,100
Summer,2008,Beijing,China,3,Russia,23,21,29,73
Summer,2008,Beijing,China,4,Great Britain,19,13,15,47
Summer,2008,Beijing,China,5,Australia,14,15,17,46
Summer,2008,Beijing,China,6,Germany,16,10,15,41
Summer,2008,Beijing,China,7,France,7,16,18,41
Summer,2008,Beijing,China,8,South Korea,13,10,8,31
Summer,2008,Beijing,China,9,Italy,8,9,10,27
Summer,2008,Beijing,China,10,Ukraine,7,5,15,27
Summer,2008,Beijing,China,11,Japan,9,6,10,25
Summer,2008,Beijing,China,12,Cuba,2,11,11,24
Summer,2008,Beijing,China,13,Belarus,4,5,10,19
Summer,2008,Beijing,China,14,Spain,5,10,3,18
Summer,2008,Beijing,China,15,Canada,3,9,6,18
Summer,2008,Beijing,China,16,Netherlands,7,5,4,16
Summer,2008,Beijing,China,17,Brazil,3,4,8,15
Summer,2008,Beijing,China,18,Kenya,6,4,4,14
Summer,2008,Beijing,China,19,Kazakhstan,2,4,7,13
Summer,2008,Beijing,China,20,Jamaica,6,3,2,11
Summer,2008,Beijing,China,21,Poland,3,6,1,10
Summer,2008,Beijing,China,22,Hungary,3,5,2,10
Summer,2008,Beijing,China,23,Norway,3,5,1,9
Summer,2008,Beijing,China,24,New Zealand,3,2,4,9
Summer,2008,Beijing,China,25,Romania,4,1,3,8
Summer,2008,Beijing,China,26,Turkey,1,4,3,8
Summer,2008,Beijing,China,27,Ethiopia,4,1,2,7
Summer,2008,Beijing,China,28,Denmark,2,2,3,7
Summer,2008,Beijing,China,29,Switzerland,2,1,4,7
Summer,2008,Beijing,China,30,Azerbaijan,1,2,4,7
Summer,2008,Beijing,China,31,Czech Republic,3,3,0,6
Summer,2008,Beijing,China,32,Slovakia,3,2,1,6
Summer,2008,Beijing,China,33,Georgia,3,0,3,6
Summer,2008,Beijing,China,34,North Korea,2,1,3,6
Summer,2008,Beijing,China,35,Argentina,2,0,4,6
Summer,2008,Beijing,China,36,Uzbekistan,1,2,3,6
Summer,2008,Beijing,China,37,Armenia,0,0,6,6
Summer,2008,Beijing,China,38,Slovenia,1,2,2,5
Summer,2008,Beijing,China,39,Indonesia,1,1,3,5
Summer,2008,Beijing,China,40,Bulgaria,1,1,3,5
Summer,2008,Beijing,China,41,Sweden,0,4,1,5
Summer,2008,Beijing,China,42,Croatia,0,2,3,5
Summer,2008,Beijing,China,43,Lithuania,0,2,3,5
Summer,2008,Beijing,China,44,Thailand,2,2,0,4
Summer,2008,Beijing,China,45,Mongolia,2,2,0,4
Summer,2008,Beijing,China,46,Zimbabwe,1,3,0,4
Summer,2008,Beijing,China,47,Finland,1,1,2,4
Summer,2008,Beijing,China,48,Greece,0,2,2,4
Summer,2008,Beijing,China,49,Nigeria,0,1,3,4
Summer,2008,Beijing,China,50,Chinese Taipei,0,0,4,4
Summer,2008,Beijing,China,51,Mexico,2,0,1,3
Summer,2008,Beijing,China,52,Latvia,1,1,1,3
Summer,2008,Beijing,China,53,India,1,0,2,3
Summer,2008,Beijing,China,54,Serbia,0,1,2,3
Summer,2008,Beijing,China,55,Ireland,0,1,2,3
Summer,2008,Beijing,China,56,Austria,0,1,2,3
Summer,2008,Beijing,China,57,Portugal,1,1,0,2
Summer,2008,Beijing,China,58,Estonia,1,1,0,2
Summer,2008,Beijing,China,59,Belgium,1,1,0,2
Summer,2008,Beijing,China,60,Dominican Republic,1,1,0,2
Summer,2008,Beijing,China,61,Iran,1,0,1,2
Summer,2008,Beijing,China,62,Trinidad and Tobago,0,2,0,2
Summer,2008,Beijing,China,63,Tajikistan,0,1,1,2
Summer,2008,Beijing,China,64,Algeria,0,1,1,2
Summer,2008,Beijing,China,65,Colombia,0,1,1,2
Summer,2008,Beijing,China,66,Kyrgyzstan,0,1,1,2
Summer,2008,Beijing,China,67,Bahamas,0,1,1,2
Summer,2008,Beijing,China,68,Morocco,0,1,1,2
Summer,2008,Beijing,China,69,Panama,1,0,0,1
Summer,2008,Beijing,China,70,Cameroon,1,0,0,1
Summer,2008,Beijing,China,71,Tunisia,1,0,0,1
Summer,2008,Beijing,China,72,Vietnam,0,1,0,1
Summer,2008,Beijing,China,73,Sudan,0,1,0,1
Summer,2008,Beijing,China,74,Ecuador,0,1,0,1
Summer,2008,Beijing,China,75,South Africa,0,1,0,1
Summer,2008,Beijing,China,76,Malaysia,0,1,0,1
Summer,2008,Beijing,China,77,Iceland,0,1,0,1
Summer,2008,Beijing,China,78,Chile,0,1,0,1
Summer,2008,Beijing,China,79,Singapore,0,1,0,1
Summer,2008,Beijing,China,80,Egypt,0,0,1,1
Summer,2008,Beijing,China,81,Israel,0,0,1,1
Summer,2008,Beijing,China,82,Afghanistan,0,0,1,1
Summer,2008,Beijing,China,83,Venezuela,0,0,1,1
Summer,2008,Beijing,China,84,Mauritius,0,0,1,1
Summer,2008,Beijing,China,85,Moldova,0,0,1,1
Summer,2008,Beijing,China,86,Togo,0,0,1,1
Summer,2004,Athina,Greece,1,United States,36,39,26,101
Summer,2004,Athina,Greece,2,Russia,28,26,36,90
Summer,2004,Athina,Greece,3,China,32,17,14,63
Summer,2004,Athina,Greece,4,Australia,17,16,17,50
Summer,2004,Athina,Greece,5,Germany,13,16,20,49
Summer,2004,Athina,Greece,6,Japan,16,9,12,37
Summer,2004,Athina,Greece,7,France,11,9,13,33
Summer,2004,Athina,Greece,8,Italy,10,11,11,32
Summer,2004,Athina,Greece,9,South Korea,9,12,9,30
Summer,2004,Athina,Greece,10,Great Britain,9,9,12,30
Summer,2004,Athina,Greece,11,Cuba,9,7,11,27
Summer,2004,Athina,Greece,12,Ukraine,8,5,9,22
Summer,2004,Athina,Greece,13,Netherlands,4,9,9,22
Summer,2004,Athina,Greece,14,Spain,3,11,6,20
Summer,2004,Athina,Greece,15,Romania,8,5,6,19
Summer,2004,Athina,Greece,16,Hungary,8,6,3,17
Summer,2004,Athina,Greece,17,Greece,6,6,4,16
Summer,2004,Athina,Greece,18,Belarus,2,5,6,13
Summer,2004,Athina,Greece,19,Canada,3,6,3,12
Summer,2004,Athina,Greece,20,Bulgaria,2,1,9,12
Summer,2004,Athina,Greece,21,Turkey,3,3,5,11
Summer,2004,Athina,Greece,22,Brazil,5,2,3,10
Summer,2004,Athina,Greece,23,Poland,3,2,5,10
Summer,2004,Athina,Greece,24,Czech Republic,1,3,5,9
Summer,2004,Athina,Greece,25,Thailand,3,1,4,8
Summer,2004,Athina,Greece,26,Denmark,2,1,5,8
Summer,2004,Athina,Greece,27,Kazakhstan,1,4,3,8
Summer,2004,Athina,Greece,28,Sweden,4,2,1,7
Summer,2004,Athina,Greece,29,Austria,2,4,1,7
Summer,2004,Athina,Greece,30,Ethiopia,2,3,2,7
Summer,2004,Athina,Greece,31,Kenya,1,4,2,7
Summer,2004,Athina,Greece,32,Norway,5,0,1,6
Summer,2004,Athina,Greece,33,Slovakia,2,2,2,6
Summer,2004,Athina,Greece,34,Iran,2,2,2,6
Summer,2004,Athina,Greece,35,Argentina,2,0,4,6
Summer,2004,Athina,Greece,36,South Africa,1,3,2,6
Summer,2004,Athina,Greece,37,New Zealand,3,2,0,5
Summer,2004,Athina,Greece,38,Chinese Taipei,2,2,1,5
Summer,2004,Athina,Greece,39,Jamaica,2,1,2,5
Summer,2004,Athina,Greece,40,Uzbekistan,2,1,2,5
Summer,2004,Athina,Greece,41,Croatia,1,2,2,5
Summer,2004,Athina,Greece,42,Switzerland,1,1,3,5
Summer,2004,Athina,Greece,43,Egypt,1,1,3,5
Summer,2004,Athina,Greece,44,Azerbaijan,1,0,4,5
Summer,2004,Athina,Greece,45,North Korea,0,4,1,5
Summer,2004,Athina,Greece,46,Georgia,2,2,0,4
Summer,2004,Athina,Greece,47,Indonesia,1,1,2,4
Summer,2004,Athina,Greece,48,Latvia,0,4,0,4
Summer,2004,Athina,Greece,49,Mexico,0,3,1,4
Summer,2004,Athina,Greece,50,Slovenia,0,1,3,4
Summer,2004,Athina,Greece,51,Morocco,2,1,0,3
Summer,2004,Athina,Greece,52,Chile,2,0,1,3
Summer,2004,Athina,Greece,53,Lithuania,1,2,0,3
Summer,2004,Athina,Greece,54,Zimbabwe,1,1,1,3
Summer,2004,Athina,Greece,55,Belgium,1,0,2,3
Summer,2004,Athina,Greece,56,Portugal,0,2,1,3
Summer,2004,Athina,Greece,57,Estonia,0,1,2,3
Summer,2004,Athina,Greece,58,Bahamas,1,0,1,2
Summer,2004,Athina,Greece,59,Israel,1,0,1,2
Summer,2004,Athina,Greece,60,Serbia and Montenegro,0,2,0,2
Summer,2004,Athina,Greece,61,Finland,0,2,0,2
Summer,2004,Athina,Greece,62,Nigeria,0,0,2,2
Summer,2004,Athina,Greece,63,Venezuela,0,0,2,2
Summer,2004,Athina,Greece,64,Colombia,0,0,2,2
Summer,2004,Athina,Greece,65,Dominican Republic,1,0,0,1
Summer,2004,Athina,Greece,66,Cameroon,1,0,0,1
Summer,2004,Athina,Greece,67,United Arab Emirates,1,0,0,1
Summer,2004,Athina,Greece,68,Paraguay,0,1,0,1
Summer,2004,Athina,Greece,69,Hong Kong,0,1,0,1
Summer,2004,Athina,Greece,70,India,0,1,0,1
Summer,2004,Athina,Greece,71,Eritrea,0,0,1,1
Summer,2004,Athina,Greece,72,Trinidad and Tobago,0,0,1,1
Summer,2004,Athina,Greece,73,Mongolia,0,0,1,1
Summer,2004,Athina,Greece,74,Syria,0,0,1,1
Summer,2000,Sydney,Australia,1,United States,37,24,32,93
Summer,2000,Sydney,Australia,2,Russia,32,28,29,89
Summer,2000,Sydney,Australia,3,China,28,16,14,58
Summer,2000,Sydney,Australia,4,Australia,16,25,17,58
Summer,2000,Sydney,Australia,5,Germany,13,17,26,56
Summer,2000,Sydney,Australia,6,France,13,14,11,38
Summer,2000,Sydney,Australia,7,Italy,13,8,13,34
Summer,2000,Sydney,Australia,8,Cuba,11,11,7,29
Summer,2000,Sydney,Australia,9,Great Britain,11,10,7,28
Summer,2000,Sydney,Australia,10,South Korea,8,10,10,28
Summer,2000,Sydney,Australia,11,Romania,11,6,9,26
Summer,2000,Sydney,Australia,12,Netherlands,12,9,4,25
Summer,2000,Sydney,Australia,13,Ukraine,3,10,10,23
Summer,2000,Sydney,Australia,14,Japan,5,8,5,18
Summer,2000,Sydney,Australia,15,Hungary,8,6,3,17
Summer,2000,Sydney,Australia,16,Belarus,3,3,11,17
Summer,2000,Sydney,Australia,17,Poland,6,5,3,14
Summer,2000,Sydney,Australia,18,Canada,3,3,8,14
Summer,2000,Sydney,Australia,19,Bulgaria,5,6,2,13
Summer,2000,Sydney,Australia,20,Greece,4,6,3,13
Summer,2000,Sydney,Australia,21,Sweden,4,5,3,12
Summer,2000,Sydney,Australia,22,Brazil,0,6,6,12
Summer,2000,Sydney,Australia,23,Spain,3,3,5,11
Summer,2000,Sydney,Australia,24,Norway,4,3,3,10
Summer,2000,Sydney,Australia,25,Switzerland,1,6,2,9
Summer,2000,Sydney,Australia,26,Jamaica,0,6,3,9
Summer,2000,Sydney,Australia,27,Ethiopia,4,1,3,8
Summer,2000,Sydney,Australia,28,Czech Republic,2,3,3,8
Summer,2000,Sydney,Australia,29,Kazakhstan,3,4,0,7
Summer,2000,Sydney,Australia,30,Kenya,2,3,2,7
Summer,2000,Sydney,Australia,31,Denmark,2,3,1,6
Summer,2000,Sydney,Australia,32,Indonesia,1,3,2,6
Summer,2000,Sydney,Australia,33,Mexico,1,2,3,6
Summer,2000,Sydney,Australia,34,Georgia,0,0,6,6
Summer,2000,Sydney,Australia,35,Turkey,3,0,2,5
Summer,2000,Sydney,Australia,36,Lithuania,2,0,3,5
Summer,2000,Sydney,Australia,37,Slovakia,1,3,1,5
Summer,2000,Sydney,Australia,38,Algeria,1,1,3,5
Summer,2000,Sydney,Australia,39,South Africa,0,2,3,5
Summer,2000,Sydney,Australia,40,Belgium,0,2,3,5
Summer,2000,Sydney,Australia,41,Morocco,0,1,4,5
Summer,2000,Sydney,Australia,42,Chinese Taipei,0,1,4,5
Summer,2000,Sydney,Australia,43,Iran,3,0,1,4
Summer,2000,Sydney,Australia,44,Finland,2,1,1,4
Summer,2000,Sydney,Australia,45,Uzbekistan,1,1,2,4
Summer,2000,Sydney,Australia,46,New Zealand,1,0,3,4
Summer,2000,Sydney,Australia,47,Argentina,0,2,2,4
Summer,2000,Sydney,Australia,48,North Korea,0,1,3,4
Summer,2000,Sydney,Australia,49,Austria,2,1,0,3
Summer,2000,Sydney,Australia,50,Bahamas,2,0,1,3
Summer,2000,Sydney,Australia,51,Azerbaijan,2,0,1,3
Summer,2000,Sydney,Australia,52,Nigeria,1,2,0,3
Summer,2000,Sydney,Australia,53,Serbia and Montenegro,1,1,1,3
Summer,2000,Sydney,Australia,54,Latvia,1,1,1,3
Summer,2000,Sydney,Australia,55,Estonia,1,0,2,3
Summer,2000,Sydney,Australia,56,Thailand,1,0,2,3
Summer,2000,Sydney,Australia,57,Slovenia,2,0,0,2
Summer,2000,Sydney,Australia,58,Croatia,1,0,1,2
Summer,2000,Sydney,Australia,59,Trinidad and Tobago,0,1,1,2
Summer,2000,Sydney,Australia,60,Saudi Arabia,0,1,1,2
Summer,2000,Sydney,Australia,61,Moldova,0,1,1,2
Summer,2000,Sydney,Australia,62,Costa Rica,0,0,2,2
Summer,2000,Sydney,Australia,63,Portugal,0,0,2,2
Summer,2000,Sydney,Australia,64,Colombia,1,0,0,1
Summer,2000,Sydney,Australia,65,Cameroon,1,0,0,1
Summer,2000,Sydney,Australia,66,Mozambique,1,0,0,1
Summer,2000,Sydney,Australia,67,Vietnam,0,1,0,1
Summer,2000,Sydney,Australia,68,Uruguay,0,1,0,1
Summer,2000,Sydney,Australia,69,Sri Lanka,0,1,0,1
Summer,2000,Sydney,Australia,70,Ireland,0,1,0,1
Summer,2000,Sydney,Australia,71,Barbados,0,0,1,1
Summer,2000,Sydney,Australia,72,Iceland,0,0,1,1
Summer,2000,Sydney,Australia,73,Kuwait,0,0,1,1
Summer,2000,Sydney,Australia,74,Israel,0,0,1,1
Summer,2000,Sydney,Australia,75,Macedonia,0,0,1,1
Summer,2000,Sydney,Australia,76,Kyrgyzstan,0,0,1,1
Summer,2000,Sydney,Australia,77,Armenia,0,0,1,1
Summer,2000,Sydney,Australia,78,Qatar,0,0,1,1
Summer,2000,Sydney,Australia,79,India,0,0,1,1
Summer,2000,Sydney,Australia,80,Chile,0,0,1,1
Summer,1996,Atlanta,United States,1,United States,44,32,25,101
Summer,1996,Atlanta,United States,2,Germany,20,18,27,65
Summer,1996,Atlanta,United States,3,Russia,26,21,16,63
Summer,1996,Atlanta,United States,4,China,16,22,12,50
Summer,1996,Atlanta,United States,5,Australia,9,9,23,41
Summer,1996,Atlanta,United States,6,France,15,7,15,37
Summer,1996,Atlanta,United States,7,Italy,13,10,12,35
Summer,1996,Atlanta,United States,8,South Korea,7,15,5,27
Summer,1996,Atlanta,United States,9,Cuba,9,8,8,25
Summer,1996,Atlanta,United States,10,Ukraine,9,2,12,23
Summer,1996,Atlanta,United States,11,Canada,3,11,8,22
Summer,1996,Atlanta,United States,12,Hungary,7,4,10,21
Summer,1996,Atlanta,United States,13,Romania,4,7,9,20
Summer,1996,Atlanta,United States,14,Netherlands,4,5,10,19
Summer,1996,Atlanta,United States,15,Poland,7,5,5,17
Summer,1996,Atlanta,United States,16,Spain,5,6,6,17
Summer,1996,Atlanta,United States,17,Bulgaria,3,7,5,15
Summer,1996,Atlanta,United States,18,Brazil,3,3,9,15
Summer,1996,Atlanta,United States,19,Great Britain,1,8,6,15
Summer,1996,Atlanta,United States,20,Belarus,1,6,8,15
Summer,1996,Atlanta,United States,21,Japan,3,6,5,14
Summer,1996,Atlanta,United States,22,Czech Republic,4,3,4,11
Summer,1996,Atlanta,United States,23,Kazakhstan,3,4,4,11
Summer,1996,Atlanta,United States,24,Greece,4,4,0,8
Summer,1996,Atlanta,United States,25,Sweden,2,4,2,8
Summer,1996,Atlanta,United States,26,Kenya,1,4,3,8
Summer,1996,Atlanta,United States,27,Switzerland,4,3,0,7
Summer,1996,Atlanta,United States,28,Norway,2,2,3,7
Summer,1996,Atlanta,United States,29,Denmark,4,1,1,6
Summer,1996,Atlanta,United States,30,Turkey,4,1,1,6
Summer,1996,Atlanta,United States,31,New Zealand,3,2,1,6
Summer,1996,Atlanta,United States,32,Belgium,2,2,2,6
Summer,1996,Atlanta,United States,33,Nigeria,2,1,3,6
Summer,1996,Atlanta,United States,34,Jamaica,1,3,2,6
Summer,1996,Atlanta,United States,35,South Africa,3,1,1,5
Summer,1996,Atlanta,United States,36,North Korea,2,1,2,5
Summer,1996,Atlanta,United States,37,Ireland,3,0,1,4
Summer,1996,Atlanta,United States,38,Finland,1,2,1,4
Summer,1996,Atlanta,United States,39,Serbia and Montenegro,1,1,2,4
Summer,1996,Atlanta,United States,40,Indonesia,1,1,2,4
Summer,1996,Atlanta,United States,41,Ethiopia,2,0,1,3
Summer,1996,Atlanta,United States,42,Algeria,2,0,1,3
Summer,1996,Atlanta,United States,43,Slovakia,1,1,1,3
Summer,1996,Atlanta,United States,44,Iran,1,1,1,3
Summer,1996,Atlanta,United States,45,Argentina,0,2,1,3
Summer,1996,Atlanta,United States,46,Austria,0,1,2,3
Summer,1996,Atlanta,United States,47,Croatia,1,1,0,2
Summer,1996,Atlanta,United States,48,Armenia,1,1,0,2
Summer,1996,Atlanta,United States,49,Portugal,1,0,1,2
Summer,1996,Atlanta,United States,50,Thailand,1,0,1,2
Summer,1996,Atlanta,United States,51,Namibia,0,2,0,2
Summer,1996,Atlanta,United States,52,Slovenia,0,2,0,2
Summer,1996,Atlanta,United States,53,Moldova,0,1,1,2
Summer,1996,Atlanta,United States,54,Uzbekistan,0,1,1,2
Summer,1996,Atlanta,United States,55,Malaysia,0,1,1,2
Summer,1996,Atlanta,United States,56,Georgia,0,0,2,2
Summer,1996,Atlanta,United States,57,Trinidad and Tobago,0,0,2,2
Summer,1996,Atlanta,United States,58,Morocco,0,0,2,2
Summer,1996,Atlanta,United States,59,Costa Rica,1,0,0,1
Summer,1996,Atlanta,United States,60,Hong Kong,1,0,0,1
Summer,1996,Atlanta,United States,61,Burundi,1,0,0,1
Summer,1996,Atlanta,United States,62,Ecuador,1,0,0,1
Summer,1996,Atlanta,United States,63,Syria,1,0,0,1
Summer,1996,Atlanta,United States,64,Philippines,0,1,0,1
Summer,1996,Atlanta,United States,65,Tonga,0,1,0,1
Summer,1996,Atlanta,United States,66,Chinese Taipei,0,1,0,1
Summer,1996,Atlanta,United States,67,Zambia,0,1,0,1
Summer,1996,Atlanta,United States,68,Bahamas,0,1,0,1
Summer,1996,Atlanta,United States,69,Latvia,0,1,0,1
Summer,1996,Atlanta,United States,70,Azerbaijan,0,1,0,1
Summer,1996,Atlanta,United States,71,Mozambique,0,0,1,1
Summer,1996,Atlanta,United States,72,Israel,0,0,1,1
Summer,1996,Atlanta,United States,73,Mongolia,0,0,1,1
Summer,1996,Atlanta,United States,74,Tunisia,0,0,1,1
Summer,1996,Atlanta,United States,75,Puerto Rico,0,0,1,1
Summer,1996,Atlanta,United States,76,Lithuania,0,0,1,1
Summer,1996,Atlanta,United States,77,India,0,0,1,1
Summer,1996,Atlanta,United States,78,Uganda,0,0,1,1
Summer,1996,Atlanta,United States,79,Mexico,0,0,1,1
Summer,1992,Barcelona,Spain,1,Unified Team,45,38,29,112
Summer,1992,Barcelona,Spain,2,United States,37,34,37,108
Summer,1992,Barcelona,Spain,3,Germany,33,21,28,82
Summer,1992,Barcelona,Spain,4,China,16,22,16,54
Summer,1992,Barcelona,Spain,5,Cuba,14,6,11,31
Summer,1992,Barcelona,Spain,6,Hungary,11,12,7,30
Summer,1992,Barcelona,Spain,7,South Korea,12,5,12,29
Summer,1992,Barcelona,Spain,8,France,8,5,16,29
Summer,1992,Barcelona,Spain,9,Australia,7,9,11,27
Summer,1992,Barcelona,Spain,10,Spain,13,7,2,22
Summer,1992,Barcelona,Spain,11,Japan,3,8,11,22
Summer,1992,Barcelona,Spain,12,Great Britain,5,3,12,20
Summer,1992,Barcelona,Spain,13,Italy,6,5,8,19
Summer,1992,Barcelona,Spain,14,Poland,3,6,10,19
Summer,1992,Barcelona,Spain,15,Canada,7,4,7,18
Summer,1992,Barcelona,Spain,16,Romania,4,6,8,18
Summer,1992,Barcelona,Spain,17,Bulgaria,3,7,6,16
Summer,1992,Barcelona,Spain,18,Netherlands,2,6,7,15
Summer,1992,Barcelona,Spain,19,Sweden,1,7,4,12
Summer,1992,Barcelona,Spain,20,New Zealand,1,4,5,10
Summer,1992,Barcelona,Spain,21,North Korea,4,0,5,9
Summer,1992,Barcelona,Spain,22,Kenya,2,4,2,8
Summer,1992,Barcelona,Spain,23,Czechoslovakia,4,2,1,7
Summer,1992,Barcelona,Spain,24,Norway,2,4,1,7
Summer,1992,Barcelona,Spain,25,Turkey,2,2,2,6
Summer,1992,Barcelona,Spain,26,Denmark,1,1,4,6
Summer,1992,Barcelona,Spain,27,Indonesia,2,2,1,5
Summer,1992,Barcelona,Spain,28,Finland,1,2,2,5
Summer,1992,Barcelona,Spain,29,Jamaica,0,3,1,4
Summer,1992,Barcelona,Spain,30,Nigeria,0,3,1,4
Summer,1992,Barcelona,Spain,31,Brazil,2,1,0,3
Summer,1992,Barcelona,Spain,32,Morocco,1,1,1,3
Summer,1992,Barcelona,Spain,33,Ethiopia,1,0,2,3
Summer,1992,Barcelona,Spain,34,Latvia,0,2,1,3
Summer,1992,Barcelona,Spain,35,Iran,0,1,2,3
Summer,1992,Barcelona,Spain,36,Belgium,0,1,2,3
Summer,1992,Barcelona,Spain,37,Croatia,0,1,2,3
Summer,1992,Barcelona,Spain,38,Individual Olympic Athletes,0,1,2,3
Summer,1992,Barcelona,Spain,39,Greece,2,0,0,2
Summer,1992,Barcelona,Spain,40,Ireland,1,1,0,2
Summer,1992,Barcelona,Spain,41,Estonia,1,0,1,2
Summer,1992,Barcelona,Spain,42,Algeria,1,0,1,2
Summer,1992,Barcelona,Spain,43,Lithuania,1,0,1,2
Summer,1992,Barcelona,Spain,44,South Africa,0,2,0,2
Summer,1992,Barcelona,Spain,45,Namibia,0,2,0,2
Summer,1992,Barcelona,Spain,46,Austria,0,2,0,2
Summer,1992,Barcelona,Spain,47,Israel,0,1,1,2
Summer,1992,Barcelona,Spain,48,Slovenia,0,0,2,2
Summer,1992,Barcelona,Spain,49,Mongolia,0,0,2,2
Summer,1992,Barcelona,Spain,50,Switzerland,1,0,0,1
Summer,1992,Barcelona,Spain,51,Chinese Taipei,0,1,0,1
Summer,1992,Barcelona,Spain,52,Mexico,0,1,0,1
Summer,1992,Barcelona,Spain,53,Peru,0,1,0,1
Summer,1992,Barcelona,Spain,54,Suriname,0,0,1,1
Summer,1992,Barcelona,Spain,55,Philippines,0,0,1,1
Summer,1992,Barcelona,Spain,56,Puerto Rico,0,0,1,1
Summer,1992,Barcelona,Spain,57,Thailand,0,0,1,1
Summer,1992,Barcelona,Spain,58,Ghana,0,0,1,1
Summer,1992,Barcelona,Spain,59,Pakistan,0,0,1,1
Summer,1992,Barcelona,Spain,60,Malaysia,0,0,1,1
Summer,1992,Barcelona,Spain,61,Argentina,0,0,1,1
Summer,1992,Barcelona,Spain,62,Qatar,0,0,1,1
Summer,1992,Barcelona,Spain,63,Bahamas,0,0,1,1
Summer,1992,Barcelona,Spain,64,Colombia,0,0,1,1
Summer,1988,Seoul,South Korea,1,Soviet Union,55,31,46,132
Summer,1988,Seoul,South Korea,2,East Germany,37,35,30,102
Summer,1988,Seoul,South Korea,3,United States,36,31,27,94
Summer,1988,Seoul,South Korea,4,West Germany,11,14,15,40
Summer,1988,Seoul,South Korea,5,Bulgaria,10,12,13,35
Summer,1988,Seoul,South Korea,6,South Korea,12,10,11,33
Summer,1988,Seoul,South Korea,7,China,5,11,12,28
Summer,1988,Seoul,South Korea,8,Romania,7,11,6,24
Summer,1988,Seoul,South Korea,9,Great Britain,5,10,9,24
Summer,1988,Seoul,South Korea,10,Hungary,11,6,6,23
Summer,1988,Seoul,South Korea,11,France,6,4,6,16
Summer,1988,Seoul,South Korea,12,Poland,2,5,9,16
Summer,1988,Seoul,South Korea,13,Italy,6,4,4,14
Summer,1988,Seoul,South Korea,14,Japan,4,3,7,14
Summer,1988,Seoul,South Korea,15,Australia,3,6,5,14
Summer,1988,Seoul,South Korea,16,New Zealand,3,2,8,13
Summer,1988,Seoul,South Korea,17,Yugoslavia,3,4,5,12
Summer,1988,Seoul,South Korea,18,Sweden,0,4,7,11
Summer,1988,Seoul,South Korea,19,Canada,3,2,5,10
Summer,1988,Seoul,South Korea,20,Kenya,5,2,2,9
Summer,1988,Seoul,South Korea,21,Netherlands,2,2,5,9
Summer,1988,Seoul,South Korea,22,Czechoslovakia,3,3,2,8
Summer,1988,Seoul,South Korea,23,Brazil,1,2,3,6
Summer,1988,Seoul,South Korea,24,Norway,2,3,0,5
Summer,1988,Seoul,South Korea,25,Denmark,2,1,1,4
Summer,1988,Seoul,South Korea,26,Spain,1,1,2,4
Summer,1988,Seoul,South Korea,27,Finland,1,1,2,4
Summer,1988,Seoul,South Korea,28,Switzerland,0,2,2,4
Summer,1988,Seoul,South Korea,29,Morocco,1,0,2,3
Summer,1988,Seoul,South Korea,30,Turkey,1,1,0,2
Summer,1988,Seoul,South Korea,31,Jamaica,0,2,0,2
Summer,1988,Seoul,South Korea,32,Argentina,0,1,1,2
Summer,1988,Seoul,South Korea,33,Belgium,0,0,2,2
Summer,1988,Seoul,South Korea,34,Mexico,0,0,2,2
Summer,1988,Seoul,South Korea,35,Suriname,1,0,0,1
Summer,1988,Seoul,South Korea,36,Austria,1,0,0,1
Summer,1988,Seoul,South Korea,37,Portugal,1,0,0,1
Summer,1988,Seoul,South Korea,38,Chile,0,1,0,1
Summer,1988,Seoul,South Korea,39,Iran,0,1,0,1
Summer,1988,Seoul,South Korea,40,Costa Rica,0,1,0,1
Summer,1988,Seoul,South Korea,41,United States Virgin Islands,0,1,0,1
Summer,1988,Seoul,South Korea,42,Netherlands Antilles,0,1,0,1
Summer,1988,Seoul,South Korea,43,Peru,0,1,0,1
Summer,1988,Seoul,South Korea,44,Indonesia,0,1,0,1
Summer,1988,Seoul,South Korea,45,Senegal,0,1,0,1
Summer,1988,Seoul,South Korea,46,Philippines,0,0,1,1
Summer,1988,Seoul,South Korea,47,Colombia,0,0,1,1
Summer,1988,Seoul,South Korea,48,Thailand,0,0,1,1
Summer,1988,Seoul,South Korea,49,Mongolia,0,0,1,1
Summer,1988,Seoul,South Korea,50,Pakistan,0,0,1,1
Summer,1988,Seoul,South Korea,51,Djibouti,0,0,1,1
Summer,1988,Seoul,South Korea,52,Greece,0,0,1,1
Summer,1984,Los Angeles,United States,1,United States,83,61,30,174
Summer,1984,Los Angeles,United States,2,West Germany,17,19,23,59
Summer,1984,Los Angeles,United States,3,Romania,20,16,17,53
Summer,1984,Los Angeles,United States,4,Canada,10,18,16,44
Summer,1984,Los Angeles,United States,5,Great Britain,5,11,21,37
Summer,1984,Los Angeles,United States,6,China,15,8,9,32
Summer,1984,Los Angeles,United States,7,Italy,14,6,12,32
Summer,1984,Los Angeles,United States,8,Japan,10,8,14,32
Summer,1984,Los Angeles,United States,9,France,5,7,16,28
Summer,1984,Los Angeles,United States,10,Australia,4,8,12,24
Summer,1984,Los Angeles,United States,11,South Korea,6,6,7,19
Summer,1984,Los Angeles,United States,12,Sweden,2,11,6,19
Summer,1984,Los Angeles,United States,13,Yugoslavia,7,4,7,18
Summer,1984,Los Angeles,United States,14,Netherlands,5,2,6,13
Summer,1984,Los Angeles,United States,15,Finland,4,2,6,12
Summer,1984,Los Angeles,United States,16,New Zealand,8,1,2,11
Summer,1984,Los Angeles,United States,17,Brazil,1,5,2,8
Summer,1984,Los Angeles,United States,18,Switzerland,0,4,4,8
Summer,1984,Los Angeles,United States,19,Mexico,2,3,1,6
Summer,1984,Los Angeles,United States,20,Denmark,0,3,3,6
Summer,1984,Los Angeles,United States,21,Spain,1,2,2,5
Summer,1984,Los Angeles,United States,22,Belgium,1,1,2,4
Summer,1984,Los Angeles,United States,23,Austria,1,1,1,3
Summer,1984,Los Angeles,United States,24,Kenya,1,0,2,3
Summer,1984,Los Angeles,United States,25,Portugal,1,0,2,3
Summer,1984,Los Angeles,United States,26,Norway,0,1,2,3
Summer,1984,Los Angeles,United States,27,Jamaica,0,1,2,3
Summer,1984,Los Angeles,United States,28,Venezuela,0,0,3,3
Summer,1984,Los Angeles,United States,29,Turkey,0,0,3,3
Summer,1984,Los Angeles,United States,30,Morocco,2,0,0,2
Summer,1984,Los Angeles,United States,31,Puerto Rico,0,1,1,2
Summer,1984,Los Angeles,United States,32,Nigeria,0,1,1,2
Summer,1984,Los Angeles,United States,33,Greece,0,1,1,2
Summer,1984,Los Angeles,United States,34,Algeria,0,0,2,2
Summer,1984,Los Angeles,United States,35,Pakistan,1,0,0,1
Summer,1984,Los Angeles,United States,36,Egypt,0,1,0,1
Summer,1984,Los Angeles,United States,37,Thailand,0,1,0,1
Summer,1984,Los Angeles,United States,38,Cote d'Ivoire,0,1,0,1
Summer,1984,Los Angeles,United States,39,Ireland,0,1,0,1
Summer,1984,Los Angeles,United States,40,Colombia,0,1,0,1
Summer,1984,Los Angeles,United States,41,Peru,0,1,0,1
Summer,1984,Los Angeles,United States,42,Syria,0,1,0,1
Summer,1984,Los Angeles,United States,43,Iceland,0,0,1,1
Summer,1984,Los Angeles,United States,44,Zambia,0,0,1,1
Summer,1984,Los Angeles,United States,45,Dominican Republic,0,0,1,1
Summer,1984,Los Angeles,United States,46,Cameroon,0,0,1,1
Summer,1984,Los Angeles,United States,47,Chinese Taipei,0,0,1,1
Summer,1980,Moskva,Soviet Union,1,Soviet Union,80,69,46,195
Summer,1980,Moskva,Soviet Union,2,East Germany,47,37,42,126
Summer,1980,Moskva,Soviet Union,3,Bulgaria,8,16,17,41
Summer,1980,Moskva,Soviet Union,4,Hungary,7,10,15,32
Summer,1980,Moskva,Soviet Union,5,Poland,3,14,15,32
Summer,1980,Moskva,Soviet Union,6,Romania,6,6,13,25
Summer,1980,Moskva,Soviet Union,7,Great Britain,5,7,9,21
Summer,1980,Moskva,Soviet Union,8,Cuba,8,7,5,20
Summer,1980,Moskva,Soviet Union,9,Italy,8,3,4,15
Summer,1980,Moskva,Soviet Union,10,France,6,5,3,14
Summer,1980,Moskva,Soviet Union,11,Czechoslovakia,2,3,9,14
Summer,1980,Moskva,Soviet Union,12,Sweden,3,3,6,12
Summer,1980,Moskva,Soviet Union,13,Yugoslavia,2,3,4,9
Summer,1980,Moskva,Soviet Union,14,Australia,2,2,5,9
Summer,1980,Moskva,Soviet Union,15,Finland,3,1,4,8
Summer,1980,Moskva,Soviet Union,16,Spain,1,3,2,6
Summer,1980,Moskva,Soviet Union,17,Denmark,2,1,2,5
Summer,1980,Moskva,Soviet Union,18,North Korea,0,3,2,5
Summer,1980,Moskva,Soviet Union,19,Brazil,2,0,2,4
Summer,1980,Moskva,Soviet Union,20,Ethiopia,2,0,2,4
Summer,1980,Moskva,Soviet Union,21,Austria,1,2,1,4
Summer,1980,Moskva,Soviet Union,22,Mongolia,0,2,2,4
Summer,1980,Moskva,Soviet Union,23,Mexico,0,1,3,4
Summer,1980,Moskva,Soviet Union,24,Greece,1,0,2,3
Summer,1980,Moskva,Soviet Union,25,Netherlands,0,1,2,3
Summer,1980,Moskva,Soviet Union,26,Jamaica,0,0,3,3
Summer,1980,Moskva,Soviet Union,27,Switzerland,2,0,0,2
Summer,1980,Moskva,Soviet Union,28,Tanzania,0,2,0,2
Summer,1980,Moskva,Soviet Union,29,Ireland,0,1,1,2
Summer,1980,Moskva,Soviet Union,30,Belgium,1,0,0,1
Summer,1980,Moskva,Soviet Union,31,India,1,0,0,1
Summer,1980,Moskva,Soviet Union,32,Zimbabwe,1,0,0,1
Summer,1980,Moskva,Soviet Union,33,Venezuela,0,1,0,1
Summer,1980,Moskva,Soviet Union,34,Uganda,0,1,0,1
Summer,1980,Moskva,Soviet Union,35,Guyana,0,0,1,1
Summer,1980,Moskva,Soviet Union,36,Lebanon,0,0,1,1
Summer,1976,Montreal,Canada,1,Soviet Union,49,41,35,125
Summer,1976,Montreal,Canada,2,United States,34,35,25,94
Summer,1976,Montreal,Canada,3,East Germany,40,25,25,90
Summer,1976,Montreal,Canada,4,West Germany,10,12,17,39
Summer,1976,Montreal,Canada,5,Romania,4,9,14,27
Summer,1976,Montreal,Canada,6,Poland,7,6,13,26
Summer,1976,Montreal,Canada,7,Japan,9,6,10,25
Summer,1976,Montreal,Canada,8,Bulgaria,6,9,7,22
Summer,1976,Montreal,Canada,9,Hungary,4,5,13,22
Summer,1976,Montreal,Canada,10,Cuba,6,4,3,13
Summer,1976,Montreal,Canada,11,Great Britain,3,5,5,13
Summer,1976,Montreal,Canada,12,Italy,2,7,4,13
Summer,1976,Montreal,Canada,13,Canada,0,5,6,11
Summer,1976,Montreal,Canada,14,France,2,3,4,9
Summer,1976,Montreal,Canada,15,Yugoslavia,2,3,3,8
Summer,1976,Montreal,Canada,16,Czechoslovakia,2,2,4,8
Summer,1976,Montreal,Canada,17,Finland,4,2,0,6
Summer,1976,Montreal,Canada,18,South Korea,1,1,4,6
Summer,1976,Montreal,Canada,19,Belgium,0,3,3,6
Summer,1976,Montreal,Canada,20,Sweden,4,1,0,5
Summer,1976,Montreal,Canada,21,Netherlands,0,2,3,5
Summer,1976,Montreal,Canada,22,Australia,0,1,4,5
Summer,1976,Montreal,Canada,23,New Zealand,2,1,1,4
Summer,1976,Montreal,Canada,24,Switzerland,1,1,2,4
Summer,1976,Montreal,Canada,25,Denmark,1,0,2,3
Summer,1976,Montreal,Canada,26,North Korea,1,1,0,2
Summer,1976,Montreal,Canada,27,Jamaica,1,1,0,2
Summer,1976,Montreal,Canada,28,Norway,1,1,0,2
Summer,1976,Montreal,Canada,29,Mexico,1,0,1,2
Summer,1976,Montreal,Canada,30,Spain,0,2,0,2
Summer,1976,Montreal,Canada,31,Portugal,0,2,0,2
Summer,1976,Montreal,Canada,32,Iran,0,1,1,2
Summer,1976,Montreal,Canada,33,Brazil,0,0,2,2
Summer,1976,Montreal,Canada,34,Trinidad and Tobago,1,0,0,1
Summer,1976,Montreal,Canada,35,Venezuela,0,1,0,1
Summer,1976,Montreal,Canada,36,Mongolia,0,1,0,1
Summer,1976,Montreal,Canada,37,Thailand,0,0,1,1
Summer,1976,Montreal,Canada,38,Puerto Rico,0,0,1,1
Summer,1976,Montreal,Canada,39,Bermuda,0,0,1,1
Summer,1976,Montreal,Canada,40,Pakistan,0,0,1,1
Summer,1976,Montreal,Canada,41,Austria,0,0,1,1
Summer,1972,Munchen,West Germany,1,Soviet Union,50,27,22,99
Summer,1972,Munchen,West Germany,2,United States,33,31,30,94
Summer,1972,Munchen,West Germany,3,East Germany,20,23,23,66
Summer,1972,Munchen,West Germany,4,West Germany,13,11,16,40
Summer,1972,Munchen,West Germany,5,Hungary,6,13,16,35
Summer,1972,Munchen,West Germany,6,Japan,13,8,8,29
Summer,1972,Munchen,West Germany,7,Poland,7,5,9,21
Summer,1972,Munchen,West Germany,8,Bulgaria,6,10,5,21
Summer,1972,Munchen,West Germany,9,Italy,5,3,10,18
Summer,1972,Munchen,West Germany,10,Great Britain,4,5,9,18
Summer,1972,Munchen,West Germany,11,Australia,8,7,2,17
Summer,1972,Munchen,West Germany,12,Sweden,4,6,6,16
Summer,1972,Munchen,West Germany,13,Romania,3,6,7,16
Summer,1972,Munchen,West Germany,14,France,2,4,7,13
Summer,1972,Munchen,West Germany,15,Kenya,2,3,4,9
Summer,1972,Munchen,West Germany,16,Cuba,3,1,4,8
Summer,1972,Munchen,West Germany,17,Finland,3,1,4,8
Summer,1972,Munchen,West Germany,18,Czechoslovakia,2,4,2,8
Summer,1972,Munchen,West Germany,19,Netherlands,3,1,1,5
Summer,1972,Munchen,West Germany,20,Yugoslavia,2,1,2,5
Summer,1972,Munchen,West Germany,21,North Korea,1,1,3,5
Summer,1972,Munchen,West Germany,22,Canada,0,2,3,5
Summer,1972,Munchen,West Germany,23,Norway,2,1,1,4
Summer,1972,Munchen,West Germany,24,New Zealand,1,1,1,3
Summer,1972,Munchen,West Germany,25,Switzerland,0,3,0,3
Summer,1972,Munchen,West Germany,26,Iran,0,2,1,3
Summer,1972,Munchen,West Germany,27,Colombia,0,1,2,3
Summer,1972,Munchen,West Germany,28,Austria,0,1,2,3
Summer,1972,Munchen,West Germany,29,Uganda,1,1,0,2
Summer,1972,Munchen,West Germany,30,Greece,0,2,0,2
Summer,1972,Munchen,West Germany,31,Belgium,0,2,0,2
Summer,1972,Munchen,West Germany,32,Brazil,0,0,2,2
Summer,1972,Munchen,West Germany,33,Ethiopia,0,0,2,2
Summer,1972,Munchen,West Germany,34,Denmark,1,0,0,1
Summer,1972,Munchen,West Germany,35,South Korea,0,1,0,1
Summer,1972,Munchen,West Germany,36,Mexico,0,1,0,1
Summer,1972,Munchen,West Germany,37,Lebanon,0,1,0,1
Summer,1972,Munchen,West Germany,38,Pakistan,0,1,0,1
Summer,1972,Munchen,West Germany,39,Tunisia,0,1,0,1
Summer,1972,Munchen,West Germany,40,Argentina,0,1,0,1
Summer,1972,Munchen,West Germany,41,Turkey,0,1,0,1
Summer,1972,Munchen,West Germany,42,Mongolia,0,1,0,1
Summer,1972,Munchen,West Germany,43,Spain,0,0,1,1
Summer,1972,Munchen,West Germany,44,Niger,0,0,1,1
Summer,1972,Munchen,West Germany,45,Ghana,0,0,1,1
Summer,1972,Munchen,West Germany,46,Nigeria,0,0,1,1
Summer,1972,Munchen,West Germany,47,India,0,0,1,1
Summer,1972,Munchen,West Germany,48,Jamaica,0,0,1,1
Summer,1968,Ciudad de Mexico,Mexico,1,United States,45,28,34,107
Summer,1968,Ciudad de Mexico,Mexico,2,Soviet Union,29,32,30,91
Summer,1968,Ciudad de Mexico,Mexico,3,Hungary,10,10,12,32
Summer,1968,Ciudad de Mexico,Mexico,4,West Germany,5,11,10,26
Summer,1968,Ciudad de Mexico,Mexico,5,Japan,11,7,7,25
Summer,1968,Ciudad de Mexico,Mexico,6,East Germany,9,9,7,25
Summer,1968,Ciudad de Mexico,Mexico,7,Poland,5,2,11,18
Summer,1968,Ciudad de Mexico,Mexico,8,Australia,5,7,5,17
Summer,1968,Ciudad de Mexico,Mexico,9,Italy,3,4,9,16
Summer,1968,Ciudad de Mexico,Mexico,10,France,7,3,5,15
Summer,1968,Ciudad de Mexico,Mexico,11,Romania,4,6,5,15
Summer,1968,Ciudad de Mexico,Mexico,12,Czechoslovakia,7,2,4,13
Summer,1968,Ciudad de Mexico,Mexico,13,Great Britain,5,5,3,13
Summer,1968,Ciudad de Mexico,Mexico,14,Kenya,3,4,2,9
Summer,1968,Ciudad de Mexico,Mexico,15,Mexico,3,3,3,9
Summer,1968,Ciudad de Mexico,Mexico,16,Bulgaria,2,4,3,9
Summer,1968,Ciudad de Mexico,Mexico,17,Yugoslavia,3,3,2,8
Summer,1968,Ciudad de Mexico,Mexico,18,Denmark,1,4,3,8
Summer,1968,Ciudad de Mexico,Mexico,19,Netherlands,3,3,1,7
Summer,1968,Ciudad de Mexico,Mexico,20,Iran,2,1,2,5
Summer,1968,Ciudad de Mexico,Mexico,21,Canada,1,3,1,5
Summer,1968,Ciudad de Mexico,Mexico,22,Switzerland,0,1,4,5
Summer,1968,Ciudad de Mexico,Mexico,23,Sweden,2,1,1,4
Summer,1968,Ciudad de Mexico,Mexico,24,Finland,1,2,1,4
Summer,1968,Ciudad de Mexico,Mexico,25,Cuba,0,4,0,4
Summer,1968,Ciudad de Mexico,Mexico,26,Austria,0,2,2,4
Summer,1968,Ciudad de Mexico,Mexico,27,Mongolia,0,1,3,4
Summer,1968,Ciudad de Mexico,Mexico,28,New Zealand,1,0,2,3
Summer,1968,Ciudad de Mexico,Mexico,29,Brazil,0,1,2,3
Summer,1968,Ciudad de Mexico,Mexico,30,Turkey,2,0,0,2
Summer,1968,Ciudad de Mexico,Mexico,31,Ethiopia,1,1,0,2
Summer,1968,Ciudad de Mexico,Mexico,32,Norway,1,1,0,2
Summer,1968,Ciudad de Mexico,Mexico,33,Tunisia,1,0,1,2
Summer,1968,Ciudad de Mexico,Mexico,34,Uganda,0,1,1,2
Summer,1968,Ciudad de Mexico,Mexico,35,South Korea,0,1,1,2
Summer,1968,Ciudad de Mexico,Mexico,36,Belgium,0,1,1,2
Summer,1968,Ciudad de Mexico,Mexico,37,Argentina,0,0,2,2
Summer,1968,Ciudad de Mexico,Mexico,38,Venezuela,1,0,0,1
Summer,1968,Ciudad de Mexico,Mexico,39,Pakistan,1,0,0,1
Summer,1968,Ciudad de Mexico,Mexico,40,Cameroon,0,1,0,1
Summer,1968,Ciudad de Mexico,Mexico,41,Jamaica,0,1,0,1
Summer,1968,Ciudad de Mexico,Mexico,42,India,0,0,1,1
Summer,1968,Ciudad de Mexico,Mexico,43,Chinese Taipei,0,0,1,1
Summer,1968,Ciudad de Mexico,Mexico,44,Greece,0,0,1,1
Summer,1964,Tokyo,Japan,1,Soviet Union,30,31,35,96
Summer,1964,Tokyo,Japan,2,United States,36,26,28,90
Summer,1964,Tokyo,Japan,3,Germany,10,22,18,50
Summer,1964,Tokyo,Japan,4,Japan,16,5,8,29
Summer,1964,Tokyo,Japan,5,Italy,10,10,7,27
Summer,1964,Tokyo,Japan,6,Poland,7,6,10,23
Summer,1964,Tokyo,Japan,7,Hungary,10,7,5,22
Summer,1964,Tokyo,Japan,8,Australia,6,2,10,18
Summer,1964,Tokyo,Japan,9,Great Britain,4,12,2,18
Summer,1964,Tokyo,Japan,10,France,1,8,6,15
Summer,1964,Tokyo,Japan,11,Czechoslovakia,5,6,3,14
Summer,1964,Tokyo,Japan,12,Romania,2,4,6,12
Summer,1964,Tokyo,Japan,13,Bulgaria,3,5,2,10
Summer,1964,Tokyo,Japan,14,Netherlands,2,4,4,10
Summer,1964,Tokyo,Japan,15,Sweden,2,2,4,8
Summer,1964,Tokyo,Japan,16,Turkey,2,3,1,6
Summer,1964,Tokyo,Japan,17,Denmark,2,1,3,6
Summer,1964,Tokyo,Japan,18,Finland,3,0,2,5
Summer,1964,Tokyo,Japan,19,New Zealand,3,0,2,5
Summer,1964,Tokyo,Japan,20,Yugoslavia,2,1,2,5
Summer,1964,Tokyo,Japan,21,Canada,1,2,1,4
Summer,1964,Tokyo,Japan,22,Switzerland,1,2,1,4
Summer,1964,Tokyo,Japan,23,Belgium,2,0,1,3
Summer,1964,Tokyo,Japan,24,South Korea,0,2,1,3
Summer,1964,Tokyo,Japan,25,Trinidad and Tobago,0,1,2,3
Summer,1964,Tokyo,Japan,26,Tunisia,0,1,1,2
Summer,1964,Tokyo,Japan,27,Iran,0,0,2,2
Summer,1964,Tokyo,Japan,28,Bahamas,1,0,0,1
Summer,1964,Tokyo,Japan,29,India,1,0,0,1
Summer,1964,Tokyo,Japan,30,Ethiopia,1,0,0,1
Summer,1964,Tokyo,Japan,31,Philippines,0,1,0,1
Summer,1964,Tokyo,Japan,32,Pakistan,0,1,0,1
Summer,1964,Tokyo,Japan,33,Cuba,0,1,0,1
Summer,1964,Tokyo,Japan,34,Argentina,0,1,0,1
Summer,1964,Tokyo,Japan,35,Mexico,0,0,1,1
Summer,1964,Tokyo,Japan,36,Uruguay,0,0,1,1
Summer,1964,Tokyo,Japan,37,Ireland,0,0,1,1
Summer,1964,Tokyo,Japan,38,Ghana,0,0,1,1
Summer,1964,Tokyo,Japan,39,Nigeria,0,0,1,1
Summer,1964,Tokyo,Japan,40,Brazil,0,0,1,1
Summer,1964,Tokyo,Japan,41,Kenya,0,0,1,1
Summer,1960,Roma,Italy,1,Soviet Union,43,29,31,103
Summer,1960,Roma,Italy,2,United States,34,21,16,71
Summer,1960,Roma,Italy,3,Germany,12,19,11,42
Summer,1960,Roma,Italy,4,Italy,13,10,13,36
Summer,1960,Roma,Italy,5,Australia,8,8,6,22
Summer,1960,Roma,Italy,6,Hungary,6,8,7,21
Summer,1960,Roma,Italy,7,Poland,4,6,11,21
Summer,1960,Roma,Italy,8,Great Britain,2,6,12,20
Summer,1960,Roma,Italy,9,Japan,4,7,7,18
Summer,1960,Roma,Italy,10,Romania,3,1,6,10
Summer,1960,Roma,Italy,11,Turkey,7,2,0,9
Summer,1960,Roma,Italy,12,Czechoslovakia,3,2,3,8
Summer,1960,Roma,Italy,13,Bulgaria,1,3,3,7
Summer,1960,Roma,Italy,14,Denmark,2,3,1,6
Summer,1960,Roma,Italy,15,Sweden,1,2,3,6
Summer,1960,Roma,Italy,16,Switzerland,0,3,3,6
Summer,1960,Roma,Italy,17,Finland,1,1,3,5
Summer,1960,Roma,Italy,18,France,0,2,3,5
Summer,1960,Roma,Italy,19,Belgium,0,2,2,4
Summer,1960,Roma,Italy,20,Iran,0,1,3,4
Summer,1960,Roma,Italy,21,New Zealand,2,0,1,3
Summer,1960,Roma,Italy,22,Netherlands,0,1,2,3
Summer,1960,Roma,Italy,23,South Africa,0,1,2,3
Summer,1960,Roma,Italy,24,Yugoslavia,1,1,0,2
Summer,1960,Roma,Italy,25,Austria,1,1,0,2
Summer,1960,Roma,Italy,26,Pakistan,1,0,1,2
Summer,1960,Roma,Italy,27,United Arab Republic,0,1,1,2
Summer,1960,Roma,Italy,28,Argentina,0,1,1,2
Summer,1960,Roma,Italy,29,Brazil,0,0,2,2
Summer,1960,Roma,Italy,30,West Indies Federation,0,0,2,2
Summer,1960,Roma,Italy,31,Norway,1,0,0,1
Summer,1960,Roma,Italy,32,Greece,1,0,0,1
Summer,1960,Roma,Italy,33,Ethiopia,1,0,0,1
Summer,1960,Roma,Italy,34,Portugal,0,1,0,1
Summer,1960,Roma,Italy,35,Ghana,0,1,0,1
Summer,1960,Roma,Italy,36,Singapore,0,1,0,1
Summer,1960,Roma,Italy,37,India,0,1,0,1
Summer,1960,Roma,Italy,38,Morocco,0,1,0,1
Summer,1960,Roma,Italy,39,Chinese Taipei,0,1,0,1
Summer,1960,Roma,Italy,40,Canada,0,1,0,1
Summer,1960,Roma,Italy,41,Iraq,0,0,1,1
Summer,1960,Roma,Italy,42,Spain,0,0,1,1
Summer,1960,Roma,Italy,43,Venezuela,0,0,1,1
Summer,1960,Roma,Italy,44,Mexico,0,0,1,1
Summer,1956,Melbourne,Australia,1,Soviet Union,37,29,32,98
Summer,1956,Melbourne,Australia,2,United States,32,25,17,74
Summer,1956,Melbourne,Australia,3,Australia,13,8,14,35
Summer,1956,Melbourne,Australia,4,Hungary,9,10,7,26
Summer,1956,Melbourne,Australia,5,Italy,8,6,8,22
Summer,1956,Melbourne,Australia,6,Great Britain,5,7,9,21
Summer,1956,Melbourne,Australia,7,Germany,4,10,6,20
Summer,1956,Melbourne,Australia,8,Japan,4,10,5,19
Summer,1956,Melbourne,Australia,9,Sweden,5,5,6,16
Summer,1956,Melbourne,Australia,10,Finland,3,1,11,15
Summer,1956,Melbourne,Australia,11,France,4,4,6,14
Summer,1956,Melbourne,Australia,12,Romania,5,3,5,13
Summer,1956,Melbourne,Australia,13,Poland,1,4,4,9
Summer,1956,Melbourne,Australia,14,Turkey,3,2,2,7
Summer,1956,Melbourne,Australia,15,Czechoslovakia,1,4,1,6
Summer,1956,Melbourne,Australia,16,Iran,2,2,1,5
Summer,1956,Melbourne,Australia,17,Canada,2,1,2,5
Summer,1956,Melbourne,Australia,18,Bulgaria,1,3,1,5
Summer,1956,Melbourne,Australia,19,Ireland,1,1,3,5
Summer,1956,Melbourne,Australia,20,Chile,0,2,2,4
Summer,1956,Melbourne,Australia,21,South Africa,0,0,4,4
Summer,1956,Melbourne,Australia,22,Denmark,1,1,1,3
Summer,1956,Melbourne,Australia,23,Norway,1,0,2,3
Summer,1956,Melbourne,Australia,24,Yugoslavia,0,3,0,3
Summer,1956,Melbourne,Australia,25,New Zealand,2,0,0,2
Summer,1956,Melbourne,Australia,26,Mexico,1,0,1,2
Summer,1956,Melbourne,Australia,27,Belgium,0,2,0,2
Summer,1956,Melbourne,Australia,28,Argentina,0,1,1,2
Summer,1956,Melbourne,Australia,29,South Korea,0,1,1,2
Summer,1956,Melbourne,Australia,30,Austria,0,0,2,2
Summer,1956,Melbourne,Australia,31,India,1,0,0,1
Summer,1956,Melbourne,Australia,32,Brazil,1,0,0,1
Summer,1956,Melbourne,Australia,33,Pakistan,0,1,0,1
Summer,1956,Melbourne,Australia,34,Iceland,0,1,0,1
Summer,1956,Melbourne,Australia,35,Bahamas,0,0,1,1
Summer,1956,Melbourne,Australia,36,Uruguay,0,0,1,1
Summer,1956,Melbourne,Australia,37,Greece,0,0,1,1
Summer,1952,Helsinki,Finland,1,United States,40,19,17,76
Summer,1952,Helsinki,Finland,2,Soviet Union,22,30,19,71
Summer,1952,Helsinki,Finland,3,Hungary,16,10,16,42
Summer,1952,Helsinki,Finland,4,Sweden,12,13,10,35
Summer,1952,Helsinki,Finland,5,Germany,0,7,17,24
Summer,1952,Helsinki,Finland,6,Finland,6,3,13,22
Summer,1952,Helsinki,Finland,7,Italy,8,9,4,21
Summer,1952,Helsinki,Finland,8,France,6,6,6,18
Summer,1952,Helsinki,Finland,9,Switzerland,2,6,6,14
Summer,1952,Helsinki,Finland,10,Czechoslovakia,7,3,3,13
Summer,1952,Helsinki,Finland,11,Australia,6,2,3,11
Summer,1952,Helsinki,Finland,12,Great Britain,1,2,8,11
Summer,1952,Helsinki,Finland,13,South Africa,2,4,4,10
Summer,1952,Helsinki,Finland,14,Japan,1,6,2,9
Summer,1952,Helsinki,Finland,15,Iran,0,3,4,7
Summer,1952,Helsinki,Finland,16,Denmark,2,1,3,6
Summer,1952,Helsinki,Finland,17,Norway,3,2,0,5
Summer,1952,Helsinki,Finland,18,Jamaica,2,3,0,5
Summer,1952,Helsinki,Finland,19,Argentina,1,2,2,5
Summer,1952,Helsinki,Finland,20,Netherlands,0,5,0,5
Summer,1952,Helsinki,Finland,21,Belgium,2,2,0,4
Summer,1952,Helsinki,Finland,22,Poland,1,2,1,4
Summer,1952,Helsinki,Finland,23,Romania,1,1,2,4
Summer,1952,Helsinki,Finland,24,Turkey,2,0,1,3
Summer,1952,Helsinki,Finland,25,Canada,1,2,0,3
Summer,1952,Helsinki,Finland,26,Yugoslavia,1,2,0,3
Summer,1952,Helsinki,Finland,27,Brazil,1,0,2,3
Summer,1952,Helsinki,Finland,28,New Zealand,1,0,2,3
Summer,1952,Helsinki,Finland,29,India,1,0,1,2
Summer,1952,Helsinki,Finland,30,Chile,0,2,0,2
Summer,1952,Helsinki,Finland,31,Austria,0,1,1,2
Summer,1952,Helsinki,Finland,32,Lebanon,0,1,1,2
Summer,1952,Helsinki,Finland,33,South Korea,0,0,2,2
Summer,1952,Helsinki,Finland,34,Trinidad and Tobago,0,0,2,2
Summer,1952,Helsinki,Finland,35,Uruguay,0,0,2,2
Summer,1952,Helsinki,Finland,36,Luxembourg,1,0,0,1
Summer,1952,Helsinki,Finland,37,Ireland,0,1,0,1
Summer,1952,Helsinki,Finland,38,Spain,0,1,0,1
Summer,1952,Helsinki,Finland,39,Mexico,0,1,0,1
Summer,1952,Helsinki,Finland,40,Portugal,0,0,1,1
Summer,1952,Helsinki,Finland,41,Bulgaria,0,0,1,1
Summer,1952,Helsinki,Finland,42,Venezuela,0,0,1,1
Summer,1952,Helsinki,Finland,43,Egypt,0,0,1,1
Summer,1948,London,Great Britain,1,United States,38,27,19,84
Summer,1948,London,Great Britain,2,Sweden,17,11,18,46
Summer,1948,London,Great Britain,3,France,11,6,15,32
Summer,1948,London,Great Britain,4,Italy,9,12,10,31
Summer,1948,London,Great Britain,5,Hungary,10,5,13,28
Summer,1948,London,Great Britain,6,Great Britain,4,16,7,27
Summer,1948,London,Great Britain,7,Finland,10,8,6,24
Summer,1948,London,Great Britain,8,Switzerland,5,12,6,23
Summer,1948,London,Great Britain,9,Denmark,5,8,9,22
Summer,1948,London,Great Britain,10,Netherlands,5,2,9,16
Summer,1948,London,Great Britain,11,Australia,2,6,5,13
Summer,1948,London,Great Britain,12,Turkey,6,4,2,12
Summer,1948,London,Great Britain,13,Czechoslovakia,6,2,3,11
Summer,1948,London,Great Britain,14,Austria,2,2,4,8
Summer,1948,London,Great Britain,15,Argentina,3,3,1,7
Summer,1948,London,Great Britain,16,Belgium,2,2,3,7
Summer,1948,London,Great Britain,17,Norway,1,3,3,7
Summer,1948,London,Great Britain,18,South Africa,2,2,2,6
Summer,1948,London,Great Britain,19,Egypt,2,2,1,5
Summer,1948,London,Great Britain,20,Mexico,2,1,2,5
Summer,1948,London,Great Britain,21,Canada,0,2,2,4
Summer,1948,London,Great Britain,22,Jamaica,1,2,0,3
Summer,1948,London,Great Britain,23,Poland,1,0,1,2
Summer,1948,London,Great Britain,24,Yugoslavia,0,2,0,2
Summer,1948,London,Great Britain,25,Portugal,0,1,1,2
Summer,1948,London,Great Britain,26,Uruguay,0,1,1,2
Summer,1948,London,Great Britain,27,South Korea,0,0,2,2
Summer,1948,London,Great Britain,28,Panama,0,0,2,2
Summer,1948,London,Great Britain,29,India,1,0,0,1
Summer,1948,London,Great Britain,30,Peru,1,0,0,1
Summer,1948,London,Great Britain,31,Cuba,0,1,0,1
Summer,1948,London,Great Britain,32,Trinidad and Tobago,0,1,0,1
Summer,1948,London,Great Britain,33,Sri Lanka,0,1,0,1
Summer,1948,London,Great Britain,34,Spain,0,1,0,1
Summer,1948,London,Great Britain,35,Puerto Rico,0,0,1,1
Summer,1948,London,Great Britain,36,Iran,0,0,1,1
Summer,1948,London,Great Britain,37,Brazil,0,0,1,1
Summer,1948,London,Great Britain,38,Ireland,0,0,1,1
Summer,1936,Berlin,Germany,1,Germany,38,31,32,101
Summer,1936,Berlin,Germany,2,United States,24,21,12,57
Summer,1936,Berlin,Germany,3,Italy,9,13,5,27
Summer,1936,Berlin,Germany,4,Sweden,6,5,10,21
Summer,1936,Berlin,Germany,5,Finland,8,6,6,20
Summer,1936,Berlin,Germany,6,Japan,6,4,10,20
Summer,1936,Berlin,Germany,7,France,7,6,6,19
Summer,1936,Berlin,Germany,8,Switzerland,4,9,5,18
Summer,1936,Berlin,Germany,9,Netherlands,6,4,7,17
Summer,1936,Berlin,Germany,10,Austria,5,7,5,17
Summer,1936,Berlin,Germany,11,Hungary,10,1,5,16
Summer,1936,Berlin,Germany,12,Great Britain,4,7,3,14
Summer,1936,Berlin,Germany,13,Czechoslovakia,3,5,1,9
Summer,1936,Berlin,Germany,14,Canada,1,3,5,9
Summer,1936,Berlin,Germany,15,Poland,0,4,5,9
Summer,1936,Berlin,Germany,16,Argentina,2,2,3,7
Summer,1936,Berlin,Germany,17,Estonia,2,2,3,7
Summer,1936,Berlin,Germany,18,Norway,1,3,2,6
Summer,1936,Berlin,Germany,19,Egypt,2,1,2,5
Summer,1936,Berlin,Germany,20,Denmark,0,2,3,5
Summer,1936,Berlin,Germany,21,Mexico,0,0,3,3
Summer,1936,Berlin,Germany,22,Belgium,0,0,3,3
Summer,1936,Berlin,Germany,23,Turkey,1,0,1,2
Summer,1936,Berlin,Germany,24,Latvia,0,1,1,2
Summer,1936,Berlin,Germany,25,India,1,0,0,1
Summer,1936,Berlin,Germany,26,New Zealand,1,0,0,1
Summer,1936,Berlin,Germany,27,South Africa,0,1,0,1
Summer,1936,Berlin,Germany,28,Romania,0,1,0,1
Summer,1936,Berlin,Germany,29,Yugoslavia,0,1,0,1
Summer,1936,Berlin,Germany,30,Philippines,0,0,1,1
Summer,1936,Berlin,Germany,31,Australia,0,0,1,1
Summer,1936,Berlin,Germany,32,Portugal,0,0,1,1
Summer,1932,Los Angeles,United States,1,United States,44,36,30,110
Summer,1932,Los Angeles,United States,2,Italy,12,12,12,36
Summer,1932,Los Angeles,United States,3,Finland,5,8,12,25
Summer,1932,Los Angeles,United States,4,Sweden,10,5,9,24
Summer,1932,Los Angeles,United States,5,Germany,5,12,7,24
Summer,1932,Los Angeles,United States,6,France,11,5,4,20
Summer,1932,Los Angeles,United States,7,Japan,7,7,4,18
Summer,1932,Los Angeles,United States,8,Great Britain,5,7,5,17
Summer,1932,Los Angeles,United States,9,Hungary,6,5,5,16
Summer,1932,Los Angeles,United States,10,Canada,2,5,9,16
Summer,1932,Los Angeles,United States,11,Poland,3,2,4,9
Summer,1932,Los Angeles,United States,12,Netherlands,2,5,1,8
Summer,1932,Los Angeles,United States,13,Denmark,0,5,3,8
Summer,1932,Los Angeles,United States,14,Czechoslovakia,1,3,2,6
Summer,1932,Los Angeles,United States,15,Australia,3,1,1,5
Summer,1932,Los Angeles,United States,16,South Africa,2,0,3,5
Summer,1932,Los Angeles,United States,17,Austria,1,1,3,5
Summer,1932,Los Angeles,United States,18,Argentina,3,1,0,4
Summer,1932,Los Angeles,United States,19,Philippines,0,0,3,3
Summer,1932,Los Angeles,United States,20,Ireland,2,0,0,2
Summer,1932,Los Angeles,United States,21,Mexico,0,2,0,2
Summer,1932,Los Angeles,United States,22,India,1,0,0,1
Summer,1932,Los Angeles,United States,23,Latvia,0,1,0,1
Summer,1932,Los Angeles,United States,24,New Zealand,0,1,0,1
Summer,1932,Los Angeles,United States,25,Switzerland,0,1,0,1
Summer,1932,Los Angeles,United States,26,Spain,0,0,1,1
Summer,1932,Los Angeles,United States,27,Uruguay,0,0,1,1
Summer,1932,Los Angeles,United States,28,Belgium,0,0,1,1
Summer,1928,Amsterdam,Netherlands,1,United States,22,18,16,56
Summer,1928,Amsterdam,Netherlands,2,Germany,11,9,19,39
Summer,1928,Amsterdam,Netherlands,3,Finland,8,8,9,25
Summer,1928,Amsterdam,Netherlands,4,France,7,12,6,25
Summer,1928,Amsterdam,Netherlands,5,Sweden,7,6,12,25
Summer,1928,Amsterdam,Netherlands,6,Netherlands,8,10,5,23
Summer,1928,Amsterdam,Netherlands,7,Great Britain,4,11,7,22
Summer,1928,Amsterdam,Netherlands,8,Italy,7,6,7,20
Summer,1928,Amsterdam,Netherlands,9,Switzerland,7,6,4,17
Summer,1928,Amsterdam,Netherlands,10,Canada,4,4,7,15
Summer,1928,Amsterdam,Netherlands,11,Hungary,5,5,0,10
Summer,1928,Amsterdam,Netherlands,12,Denmark,3,2,4,9
Summer,1928,Amsterdam,Netherlands,13,Czechoslovakia,2,5,2,9
Summer,1928,Amsterdam,Netherlands,14,Argentina,3,3,1,7
Summer,1928,Amsterdam,Netherlands,15,Poland,2,1,4,7
Summer,1928,Amsterdam,Netherlands,16,Japan,2,2,1,5
Summer,1928,Amsterdam,Netherlands,17,Estonia,2,1,2,5
Summer,1928,Amsterdam,Netherlands,18,Yugoslavia,1,1,3,5
Summer,1928,Amsterdam,Netherlands,19,Austria,3,0,1,4
Summer,1928,Amsterdam,Netherlands,20,Egypt,2,1,1,4
Summer,1928,Amsterdam,Netherlands,21,Australia,1,2,1,4
Summer,1928,Amsterdam,Netherlands,22,Norway,1,2,1,4
Summer,1928,Amsterdam,Netherlands,23,South Africa,1,0,2,3
Summer,1928,Amsterdam,Netherlands,24,Belgium,0,1,2,3
Summer,1928,Amsterdam,Netherlands,25,New Zealand,1,0,0,1
Summer,1928,Amsterdam,Netherlands,26,Uruguay,1,0,0,1
Summer,1928,Amsterdam,Netherlands,27,India,1,0,0,1
Summer,1928,Amsterdam,Netherlands,28,Ireland,1,0,0,1
Summer,1928,Amsterdam,Netherlands,29,Spain,1,0,0,1
Summer,1928,Amsterdam,Netherlands,30,Luxembourg,1,0,0,1
Summer,1928,Amsterdam,Netherlands,31,Chile,0,1,0,1
Summer,1928,Amsterdam,Netherlands,32,Haiti,0,1,0,1
Summer,1928,Amsterdam,Netherlands,33,Philippines,0,0,1,1
Summer,1928,Amsterdam,Netherlands,34,Portugal,0,0,1,1
Summer,1924,Paris,France,1,United States,45,27,27,99
Summer,1924,Paris,France,2,France,14,15,12,41
Summer,1924,Paris,France,3,Finland,14,13,10,37
Summer,1924,Paris,France,4,Great Britain,9,14,12,35
Summer,1924,Paris,France,5,Sweden,4,13,12,29
Summer,1924,Paris,France,6,Switzerland,7,8,10,25
Summer,1924,Paris,France,7,Italy,8,3,5,16
Summer,1924,Paris,France,8,Belgium,3,7,3,13
Summer,1924,Paris,France,9,Netherlands,4,1,6,11
Summer,1924,Paris,France,10,Denmark,2,6,3,11
Summer,1924,Paris,France,11,Norway,5,2,3,10
Summer,1924,Paris,France,12,Hungary,2,4,4,10
Summer,1924,Paris,France,13,Czechoslovakia,1,4,5,10
Summer,1924,Paris,France,14,Australia,3,1,2,6
Summer,1924,Paris,France,15,Argentina,1,3,2,6
Summer,1924,Paris,France,16,Estonia,1,1,4,6
Summer,1924,Paris,France,17,Canada,0,3,1,4
Summer,1924,Paris,France,18,Austria,0,3,1,4
Summer,1924,Paris,France,19,South Africa,1,1,1,3
Summer,1924,Paris,France,20,Yugoslavia,2,0,0,2
Summer,1924,Paris,France,21,Luxembourg,1,1,0,2
Summer,1924,Paris,France,22,Poland,0,1,1,2
Summer,1924,Paris,France,23,Ireland,0,1,1,2
Summer,1924,Paris,France,24,Uruguay,1,0,0,1
Summer,1924,Paris,France,25,Greece,1,0,0,1
Summer,1924,Paris,France,26,Romania,0,0,1,1
Summer,1924,Paris,France,27,New Zealand,0,0,1,1
Summer,1924,Paris,France,28,Haiti,0,0,1,1
Summer,1924,Paris,France,29,Portugal,0,0,1,1
Summer,1924,Paris,France,30,Japan,0,0,1,1
Summer,1924,Paris,France,31,Monaco,0,0,1,1
Summer,1920,Antwerpen,Belgium,1,United States,41,27,27,95
Summer,1920,Antwerpen,Belgium,2,Sweden,19,20,25,64
Summer,1920,Antwerpen,Belgium,3,Great Britain,14,16,13,43
Summer,1920,Antwerpen,Belgium,4,Belgium,16,12,14,42
Summer,1920,Antwerpen,Belgium,5,France,9,20,13,42
Summer,1920,Antwerpen,Belgium,6,Finland,15,10,9,34
Summer,1920,Antwerpen,Belgium,7,Norway,13,10,9,32
Summer,1920,Antwerpen,Belgium,8,Italy,14,6,5,25
Summer,1920,Antwerpen,Belgium,9,Denmark,3,9,1,13
Summer,1920,Antwerpen,Belgium,10,Netherlands,4,2,5,11
Summer,1920,Antwerpen,Belgium,11,Switzerland,2,2,7,11
Summer,1920,Antwerpen,Belgium,12,South Africa,3,4,3,10
Summer,1920,Antwerpen,Belgium,13,Canada,3,3,3,9
Summer,1920,Antwerpen,Belgium,14,Estonia,1,2,0,3
Summer,1920,Antwerpen,Belgium,15,Brazil,1,1,1,3
Summer,1920,Antwerpen,Belgium,16,Australia,0,2,1,3
Summer,1920,Antwerpen,Belgium,17,Spain,0,2,0,2
Summer,1920,Antwerpen,Belgium,18,Japan,0,2,0,2
Summer,1920,Antwerpen,Belgium,19,Czechoslovakia,0,0,2,2
Summer,1920,Antwerpen,Belgium,20,Luxembourg,0,1,0,1
Summer,1920,Antwerpen,Belgium,21,Greece,0,1,0,1
Summer,1920,Antwerpen,Belgium,22,New Zealand,0,0,1,1
Summer,1912,Stockholm,Sweden,1,Sweden,24,24,17,65
Summer,1912,Stockholm,Sweden,2,United States,26,19,19,64
Summer,1912,Stockholm,Sweden,3,Great Britain,10,15,16,41
Summer,1912,Stockholm,Sweden,4,Finland,9,8,9,26
Summer,1912,Stockholm,Sweden,5,Germany,6,13,7,26
Summer,1912,Stockholm,Sweden,6,France,7,5,3,15
Summer,1912,Stockholm,Sweden,7,Denmark,1,6,5,12
Summer,1912,Stockholm,Sweden,8,Norway,4,1,5,10
Summer,1912,Stockholm,Sweden,9,Italy,5,1,2,8
Summer,1912,Stockholm,Sweden,10,Canada,3,2,3,8
Summer,1912,Stockholm,Sweden,11,Hungary,3,2,3,8
Summer,1912,Stockholm,Sweden,12,Australasia,2,2,3,7
Summer,1912,Stockholm,Sweden,13,South Africa,4,2,0,6
Summer,1912,Stockholm,Sweden,14,Belgium,2,1,3,6
Summer,1912,Stockholm,Sweden,15,Russia,0,2,3,5
Summer,1912,Stockholm,Sweden,16,Austria,0,2,2,4
Summer,1912,Stockholm,Sweden,17,Netherlands,0,0,3,3
Summer,1912,Stockholm,Sweden,18,Greece,1,0,1,2
Summer,1912,Stockholm,Sweden,19,Switzerland,1,0,0,1
Summer,1908,London,Great Britain,1,Great Britain,56,51,39,146
Summer,1908,London,Great Britain,2,United States,23,12,12,47
Summer,1908,London,Great Britain,3,Sweden,8,6,11,25
Summer,1908,London,Great Britain,4,France,5,5,9,19
Summer,1908,London,Great Britain,5,Canada,3,3,10,16
Summer,1908,London,Great Britain,6,Germany,3,5,5,13
Summer,1908,London,Great Britain,7,Hungary,3,4,2,9
Summer,1908,London,Great Britain,8,Norway,2,3,3,8
Summer,1908,London,Great Britain,9,Belgium,1,5,2,8
Summer,1908,London,Great Britain,10,Australasia,1,2,2,5
Summer,1908,London,Great Britain,11,Finland,1,1,3,5
Summer,1908,London,Great Britain,12,Denmark,0,2,3,5
Summer,1908,London,Great Britain,13,Italy,2,2,0,4
Summer,1908,London,Great Britain,14,Greece,0,3,1,4
Summer,1908,London,Great Britain,15,Russia,1,2,0,3
Summer,1908,London,Great Britain,16,South Africa,1,1,0,2
Summer,1908,London,Great Britain,17,Netherlands,0,0,2,2
Summer,1908,London,Great Britain,18,Bohemia,0,0,2,2
Summer,1908,London,Great Britain,19,Austria,0,0,1,1
Summer,1906,Athina,Greece,1,France,15,9,16,40
Summer,1906,Athina,Greece,2,Greece,8,13,13,34
Summer,1906,Athina,Greece,3,United States,12,6,6,24
Summer,1906,Athina,Greece,4,Great Britain,8,11,5,24
Summer,1906,Athina,Greece,5,Italy,7,6,3,16
Summer,1906,Athina,Greece,6,Germany,4,6,5,15
Summer,1906,Athina,Greece,7,Sweden,2,5,7,14
Summer,1906,Athina,Greece,8,Hungary,2,5,3,10
Summer,1906,Athina,Greece,9,Austria,3,3,3,9
Summer,1906,Athina,Greece,10,Switzerland,4,3,1,8
Summer,1906,Athina,Greece,11,Denmark,3,2,1,6
Summer,1906,Athina,Greece,12,Belgium,2,1,3,6
Summer,1906,Athina,Greece,13,Finland,2,1,1,4
Summer,1906,Athina,Greece,14,Netherlands,0,1,2,3
Summer,1906,Athina,Greece,15,Australia,0,0,3,3
Summer,1906,Athina,Greece,16,Canada,1,1,0,2
Summer,1906,Athina,Greece,17,Norway,1,1,0,2
Summer,1906,Athina,Greece,18,Mixed team,0,2,0,2
Summer,1906,Athina,Greece,19,Bohemia,0,0,2,2
Summer,1904,St. Louis,United States,1,United States,76,78,77,231
Summer,1904,St. Louis,United States,2,Germany,4,5,6,15
Summer,1904,St. Louis,United States,3,Canada,4,1,1,6
Summer,1904,St. Louis,United States,4,Hungary,2,1,1,4
Summer,1904,St. Louis,United States,5,Mixed team,2,1,1,4
Summer,1904,St. Louis,United States,6,Australia,0,3,1,4
Summer,1904,St. Louis,United States,7,Cuba,3,0,0,3
Summer,1904,St. Louis,United States,8,Austria,1,1,1,3
Summer,1904,St. Louis,United States,9,Switzerland,1,0,2,3
Summer,1904,St. Louis,United States,10,Norway,2,0,0,2
Summer,1904,St. Louis,United States,11,Great Britain,1,1,0,2
Summer,1904,St. Louis,United States,12,Greece,1,0,1,2
Summer,1904,St. Louis,United States,13,France,0,1,0,1
Summer,1900,Paris,France,1,France,27,39,37,103
Summer,1900,Paris,France,2,United States,19,14,14,47
Summer,1900,Paris,France,3,Great Britain,15,8,9,32
Summer,1900,Paris,France,4,Mixed team,7,4,7,18
Summer,1900,Paris,France,5,Belgium,6,7,4,17
Summer,1900,Paris,France,6,Switzerland,6,2,1,9
Summer,1900,Paris,France,7,Germany,4,3,2,9
Summer,1900,Paris,France,8,Denmark,1,3,2,6
Summer,1900,Paris,France,9,Netherlands,1,2,3,6
Summer,1900,Paris,France,10,Austria,0,3,3,6
Summer,1900,Paris,France,11,Italy,3,2,0,5
Summer,1900,Paris,France,12,Australia,2,0,3,5
Summer,1900,Paris,France,13,Hungary,1,2,2,5
Summer,1900,Paris,France,14,Norway,0,2,3,5
Summer,1900,Paris,France,15,Cuba,1,1,0,2
Summer,1900,Paris,France,16,Canada,1,0,1,2
Summer,1900,Paris,France,17,India,0,2,0,2
Summer,1900,Paris,France,18,Bohemia,0,1,1,2
Summer,1900,Paris,France,19,Spain,1,0,0,1
Summer,1900,Paris,France,20,Luxembourg,1,0,0,1
Summer,1900,Paris,France,21,Sweden,0,0,1,1
Summer,1896,Athina,Greece,1,Greece,10,18,19,47
Summer,1896,Athina,Greece,2,United States,11,7,2,20
Summer,1896,Athina,Greece,3,Germany,6,5,2,13
Summer,1896,Athina,Greece,4,France,5,4,2,11
Summer,1896,Athina,Greece,5,Great Britain,2,3,2,7
Summer,1896,Athina,Greece,6,Hungary,2,1,3,6
Summer,1896,Athina,Greece,7,Denmark,1,2,3,6
Summer,1896,Athina,Greece,8,Austria,2,1,2,5
Summer,1896,Athina,Greece,9,Switzerland,1,2,0,3
Summer,1896,Athina,Greece,10,Australia,2,0,0,2
Summer,1896,Athina,Greece,11,Mixed team,1,0,1,2
